{
	"width": 56,
	"height": 34,
	"ambient": null,
	"baseLayer": {
		"ids": [
			"WATER",
			"GROUND_0_0",
			"GROUND_2_0",
			"GROUND_3_0",
			"GROUND_0_1",
			"GROUND_2_1",
			"GROUND_1_0"
		],
		"grid": [
			"11111111111122222222222222222222222222222222222222222222",
			"11111111111122222222222222222222222222222222222222222222",
			"11111111111122222222222222222222222222222222223333333322",
			"11111111111122222444444444444444222224444222223333333322",
			"11111111111122222444444444444444222224444222223333333322",
			"11111111111122222444444444444444222224444222223333333322",
			"11111111111122222444444444444444222222422222232223322222",
			"11111111111122222444444444444444222222222222222223322222",
			"11111111111122222224224222422422222225522222222222222222",
			"11661111111122222444255555552444222225522222222225522222",
			"11661111111122222444255555552444222225522222222225522222",
			"11661111111122222444255555552444222225555555555555522222",
			"11666661111122222222255555552222222225555555555555522222",
			"11666661111122222222222555222222222222225522222225522222",
			"11111111111122222222222555222222222222225522222225522222",
			"11111111111122222222222555222225555555555522222225522222",
			"11111111111122222222222555222225555555555522222222222222",
			"11111111111122222222222555222225522222222222222222222222",
			"11111111111122222222222555555555522222223322222222222222",
			"11111111111122222222222555555555522222223322222222222222",
			"11111111111122222222222555222225522223333333322222222222",
			"11111111111222222222222555222225522223333333322222222222",
			"11111111111222222222222555222222222223333333322222222222",
			"11111111111222222222222555222222222223333333322222222222",
			"11111111112222222222222555222222222222222222222222222222",
			"11111111112222222222222222222222222222222222222222222222",
			"11111111122222222222222222222222222222222222222222222222",
			"11111111244444444444444222444444444444444444444444444444",
			"11111122222222222222222222222222222222222222222222222222",
			"11122222222222222222222222222222222222222222222222222222",
			"22222222222222222222222277222222222222222222222222222222",
			"22222222222222222222222277222222222222222222222222222222",
			"22222222222222222222222277222222222222222222222222222222",
			"22222222222222222222222277222222222222222222222222222222"
		]
	},
	"overLayer": {
		"ids": [
			"0_0_2_1",
			"2_0_3_4",
			"2_0_2_3",
			"2_0_0_3",
			"2_0_4_4",
			"2_1_3_0",
			"2_1_1_2",
			"2_1_4_0",
			"0_0_0_0",
			"0_0_2_0",
			"2_0_1_3",
			"2_1_2_1",
			"2_1_0_1",
			"0_0_0_1",
			"2_1_0_2",
			"0_0_3_1",
			"0_0_1_0",
			"0_0_4_1",
			"0_0_1_2",
			"0_0_4_0",
			"0_0_3_0",
			"0_0_0_2",
			"2_1_3_1",
			"2_1_1_0",
			"2_1_4_1",
			"0_0_2_2",
			"2_0_3_3",
			"2_0_1_5",
			"2_0_4_3",
			"2_0_2_5",
			"2_0_0_5",
			"0_0_3_3"
		],
		"grid": [
			"0000000000000000000000010000000000000000000000000000000000000000000000000000000000000000000000000000000000000000",
			"0000000000000000000000010000000000000000000000000000000000000000000000000000000000000000000000000000000000000000",
			"0000000000000000000000010000000000000000000000000000000000000000000000000000000000000000000000000000000000000000",
			"0000000000000000000000010000000000000000000000000000000000000000000000000000000000000000000000000000000000000000",
			"0000000000000000000000010000000000000000000000000000000000000000000000000000000000000000000000000000000000000000",
			"0000000000000000000000010000000000000000000000000000000000000000000000000000000000000000000000000000000000000000",
			"0000000000000000000000010000000000000000000000000000000000000000000000000000000000000000000000000000000000000000",
			"0000000000000000000000010000000000000000000000000000000000000000000000000000000000000000000000020300000405000000",
			"0006070708000000000000010000000000000000000000000000000000000000000000000009100000000000000000000211110500000000",
			"0012000013000000000000010000000000000000000000000000000000000000000000000014010000000000000000000009100000000000",
			"0012000013000000000000010000000000000000000000000000000000000000000000000014010000000000000000000014010000000000",
			"0012000015070708000000010000000000000000000000000000000000000000000000000014161717171717171717171718010000000000",
			"0012000000000013000000010000000000000000001919200021191900000000000000000022191920211919191919191920010000000000",
			"0012000000000013000000010000000000000000000000140001000000000000000000000000000014010000000000000014010000000000",
			"0023242424242425000000010000000000000000000000140001000000000000000000000000000014010000000000000014010000000000",
			"0000000000000000000000010000000000000000000000140001000000000009171717171717171718010000000000000022260000000000",
			"0000000000000000000000010000000000000000000000140001000000000014211919191919191919260000000000000000000000000000",
			"0000000000000000000000010000000000000000000000140001000000000014010000000000002728282900000000000000000000000000",
			"0000000000000000000000010000000000000000000000140016171717171718010000000000273000003129000000000000000000000000",
			"0000000000000000000000010000000000000000000000140021191919191920010000000000000000000000000000000000000000000000",
			"0000000000000000000032260000000000000000000000140001000000000014010000000000000000000000000000000000000000000000",
			"0000000000000000000001000000000000000000000000140001000000000022260000000000000000000000000000000000000000000000",
			"0000000000000000000001000000000000000000000000140001000000000000000000000000000000000000000000000000000000000000",
			"0000000000000000003226000000000000000000000000140001000000000000000000000000000000000000000000000000000000000000",
			"0000000000000000000100000000000000000000000000221926000000000000000000000000000000000000000000000000000000000000",
			"0000000000000000322600000000000000000000000000000000000000000000000000000000000000000000000000000000000000000000",
			"0000000000000032260000000000000000000000000000000000000000000000000000000000000000000000000000000000000000000000",
			"0000000000321926000000000000000000000000000000000000000000000000000000000000000000000000000000000000000000000000",
			"0000321919260000000000000000000000000000000000000000000000000000000000000000000000000000000000000000000000000000",
			"1919260000000000000000000000000000000000000000000000000000000000000000000000000000000000000000000000000000000000",
			"0000000000000000000000000000000000000000000000000910000000000000000000000000000000000000000000000000000000000000",
			"0000000000000000000000000000000000000000000000001401000000000000000000000000000000000000000000000000000000000000",
			"0000000000000000000000000000000000000000000000001401000000000000000000000000000000000000000000000000000000000000",
			"0000000000000000000000000000000000000000000000001401000000000000000000000000000000000000000000000000000000000000"
		]
	},
	"wallLayer": {
		"ids": [
			"1_0",
			"3_0",
			"0_0"
		],
		"grid": [
			"00000000000000000000000000000000000000000000000000000000",
			"00000000000000000000000000000000000000000000011111111110",
			"00000022000000003333333333333333300033333300010000000010",
			"00000022000000003000000000000000300030000300010000000010",
			"00000022222200003000000030000000300030000300010000000010",
			"00000022222200003000000030000000300030000300010000000010",
			"00000000000000003000000030000000300033033300011110011110",
			"00000000000000003000000000000000300000000000000000000000",
			"00000000000000003330330333033033300000000000000000000000",
			"00000000000000003000300000003000300000000000000000000000",
			"00000000000000003000300000003000300000000000000000000000",
			"00000000000000003000300000003000300000000000000000000000",
			"00000000000000003333300000003333300000000000000000000000",
			"00000000000000000000000000000000000000000000000000000000",
			"00000000000000000000000000000000000000000000000000000000",
			"00000000000000000000000000000000000000000000000000000000",
			"00000000000000000000000000000000000000000000000000000000",
			"00000000000000000000000000000000000000000000000000000000",
			"00000000000000000000000000000000000000000000000000000000",
			"00000000000000000000000000000000000011110011110000000000",
			"00000000000000000000000000000000000010000000010000000000",
			"00000000000000000000000000000000000010000000010000000000",
			"00000000000000000000000000000000000010000000010000000000",
			"00000000000000000000000000000000000010000000010000000000",
			"00000000000000000000000000000000000011111111110000000000",
			"00000000000000000000000000000000000000000000000000000000",
			"00000000333333333333333000333333333333333333333333333333",
			"00000000300000000000003000300000000000000000000000000000",
			"00000000333333333333333000333333333333333333333333333333",
			"00000000000000000000000000000000000000000000000000000000",
			"00000000000000000000000000000000000000000000000000000000",
			"00000000000000000000000000000000000000000000000000000000",
			"00000000000000000000000000000000000000000000000000000000",
			"00000000000000000000000000000000000000000000000000000000"
		]
	},
	"attribLayer": {
		"ids": [
			"ISLAND",
			"BLOCK",
			"OBJECT: tree_common",
			"OBJECT: crate_small",
			"OBJECT: fishing_spot",
			"WARP: dungeon 17 15",
			"OBJECT: torch_wall",
			"OBJECT: furnace",
			"OBJECT: anvil",
			"OBJECT: torch_common",
			"NPC_AVOID",
			"NPC: woman_d",
			"NPC: woman_a",
			"NPC: carl_armor",
			"OBJECT: door_closed",
			"OBJECT: bush_strawberry",
			"WARP: dungeon 13 0",
			"OBJECT: range",
			"OBJECT: tree_apple",
			"NPC: man_b",
			"NPC: scorpion",
			"ITEM: coins",
			"NPC: guard",
			"NPC: man_a",
			"OBJECT: fountain",
			"OBJECT: tree_birch",
			"NPC: banker_a",
			"NPC: banker_b",
			"WARP: newbie_east_route 72 2",
			"WARP: newbie_east_route 73 2"
		],
		"grid": [
			"0100000002020202020001020000000000030000000000030000000003000002000000000000000000000000010204000000000000000000",
			"0000000002050505020000020006000000000000000000000000000000000002000000000000000002000000000207020202020202070200",
			"0000000002050000020000020000000002020202020202020202020202020202020000000202020207020000000200080000000009000200",
			"0000000002050000100202020003000002000000000000001100000000000000020000000200000000020000000200000000000000000200",
			"0000000002050000000000110000000002001200000000000200000000001300020202020200001400020202020200000000000009000200",
			"0000000002050000000000110000000002000000000000000200000000000000020000000200000000020000000200000000000000000200",
			"0000000002020202020202020000000002000000000000000200000000000000020000000207150702020000000202020711110702020200",
			"0000000000000000000000020000030002000000000000001100000000000000020000000000000016000000000000000000000000000000",
			"0002020202000000000000020000000002020215020215020202150202150202020003000000000000000000000000000000000000000000",
			"0002170002000000000000020000000002000000020000000000000002001800020000000000000000000000000000000000000000190000",
			"0002000002000000000000020000000002002000020000000000000002000000020000000000001000000202020200001000000000000000",
			"0002000002020202000000020003000002000000020000000000000002000000020000190000000000000000000000000000000000000000",
			"0002002100000402000000020000000002020202020000000000000002020202020000000000000000000000000000000000000003000000",
			"0002010000002202000000020000000000000000000000002300000000000000000000000000000000000024000202020200000000000000",
			"0002020202020202000000020000000000000000000000000000000000000000000000000300001000000000000000000300000000000000",
			"0000000000000000000000020000000023000000000000000000000000000000230000000000000000000000000000000000000000000000",
			"0000000000000000000000020000000000000000000000000000000000000000000000000000000000000000001900000000000000030000",
			"0000000000000000000000020000000000000025000000002300250000001000000000000000000000000000000000000003000000000000",
			"0000000000000000000000020000001900000000000000000000000000000000001900000000000000000000000000000000000000000000",
			"0000000000000000000000020000000000000000000000000000000000000000000000000202020711110702020200000000000000000000",
			"0000000000000000000002020000000000000000000000000000100000000000000000000200000000000022000200000000000000000000",
			"0000000000000000000002000000000000000000260000000000000026000000000000000200270000000000000200000003000000000000",
			"0000000000000000000002000000000000000000000000000000000000000000000000000200000000000028000200000000000000000000",
			"0000000000000000000202000000000000000000000000000000000000001900000000000204000000000000000200000000000000000000",
			"0000000000000000000200000000001900000000000010000000100000000000001900000207020202020202070200000000000000260000",
			"0000000000000000020200000000000000000000000000000000000000000000000000000000000000000000000000000000000000000000",
			"0000000000000002020202020202020202020202020202000000020202020202020202020202020202020202020202020202020202020202",
			"0000000000020202020100000000000000000000000002111111020100000000000000000000000000000000000000000000000000000000",
			"0000020202020000020202020202020202020202020202000000020202020202020202020202020202020202020202020202020202020202",
			"0202020000000000000000000000000200030000000000000000000000000000000000000000000000000000000000000000000000000200",
			"0000000000000000230000000000000200000000230000000000000023000000000000000003000000000000000003000000000300000200",
			"0000000000260000000000000026000200000000000003000000000300000000000000000000000000000000000000000000000000000200",
			"0000000000000000000000230000000202020202020202022930020202020202020202020202020202020202020202020202020202020200",
			"0000000000000000000000000000000000000000000000000000000000000000000000000000000000000000000000000000000000000000"
		]
	},
	"decoLayer": {
		"ids": [
			"0_0",
			"2_4",
			"1_0",
			"0_2",
			"3_0",
			"2_0",
			"1_1",
			"4_1",
			"0_1",
			"2_1",
			"4_4",
			"2_5",
			"3_5",
			"4_0",
			"4_5"
		],
		"grid": [
			"0000000000000000000000000000000000000000010000000000000000000002030000000000030000000000000000000000000000000000",
			"0000000000000000000000000004000000000000000000000000010000000002000005000000000000000005000000000000000000000000",
			"0000000000000000000000000000000000000000000000000000000000000000000000000000000000000000060000000000000000000000",
			"0000000000000000000000000000000000000000000000000000000000000000000000000000000000000000000000000000000000000000",
			"0000000000000000000000000000000000000000000000000000000000000000000707070000000000000707070000000000000000000000",
			"0000000000000000000000000000000000000000000000000000000000000000000000000000000000000000000000000000000000000000",
			"0000000000000000000000000000000000000000000000000000000000000000000000000000000000000000000000000000000000000000",
			"0000000000000000000000000100000000000000000000000000000000000000000000000000000000000000060000000000000000000000",
			"0000000000000000000000000000000000000000000000000800000000000000000000000000000000000006000000000000000000000000",
			"0000040000000000000000000000000000000000000000000000000000000000000000000000000000000000000000000000000000000000",
			"0000000000000000000000000000000100000000000000000000000000000000000000000000000000000907071000000000000000000000",
			"0000000000000000000000000000000000000000000000000000000000000000000000000000000000000000000000000000000000000000",
			"0000000000000000000000000000000000000800000000000000000000000800000000000000000000000000000000000000000000000500",
			"0000000000000000000000000000000000000000000000000000000000000000000000000000000000000000000907071000000000000000",
			"0000000000000000000000000000000000000000000000000000000000000003000000000000000000000000000000000000000000000000",
			"0000000000000000000000000000000500000000000000000000000000000000000000000000000000000000000000000000000000000000",
			"0000000000000000000000000000000000000000000000000000000000000300000000000000000000000000000000000000000000000000",
			"0000000000000000000000000000000000000000000000000000000000000000000000000000000000000000000000050000000000000000",
			"0000000000000000000000000000000000000000000000000000000000000000000000000000000000000000000000000000000000000000",
			"0000000000000000000000000000000000000000000000000000000000000000000000000000000000000000000000000000000000010000",
			"0000000000000000000000000000000000000000000000000000000000000000000000000000000000000000000000000000000000000100",
			"0000000000000000000000000000000000060000000000000000000000000000000000000000000000000000000000000000000000000000",
			"0000000000000000000000000000000000000600000000000000000000000005000000000000000000000000000000000000000600000000",
			"0000000000000000000000000003000000000000000000000000000000000000000000000000000000000000000000000000000000000000",
			"0000000000000000000000000300000000000000000000000000000000000000000000000000000000000000000000000000000500000000",
			"0000000000000000000000000000000000000000000000000000000000000000000000000000000000000000000000000000000000000000",
			"0000000000000000000000000000000000000000000000000000000000000000000000000000000000000000000000000000000000000000",
			"0000000000000000000000000000000000000000000000000000000000000000000000000000000000000000000000000000000000000000",
			"0000000000000000000000000000000000000000080000000000000008000000000000000000000000000000000000000000000000000000",
			"0000000000000000000000000000000200000000010000000000000000000000030000000000000000000000000000000000000000001100",
			"0000000000000000000003000000000200000001000000000000000000000300000000000000000000060000000000000005000000001100",
			"0006000000000000000300000000000200000000050000000000000000000000000005000000000000000600000000000000000000001100",
			"0000000500000000000000000000001213131313131313101414091313131313131313131313131313131313131313131313131313131500",
			"0000000000000000000000000000000000000000000000000000000000000000000000000000000000000000000000000000000000000000"
		]
	}
}