{
	"width": 20,
	"height": 20,
	"ambient": [
		0.5,
		0.5,
		0.5
	],
	"baseLayer": {
		"ids": [
			"GROUND_1_1",
			"WATER"
		],
		"grid": [
			"11111111111111111111",
			"11111111122111111111",
			"11111111122111111111",
			"11111111122111111111",
			"11111111122111111111",
			"11111111122111111111",
			"11111111122111111111",
			"11111111122111111111",
			"11111111122111111111",
			"11111111122111111111",
			"11111111122111111111",
			"11111111122111111111",
			"11111111111111111111",
			"11111111111111111111",
			"11111111111111111111",
			"11111111111111111111",
			"11111111111111111111",
			"11111111111111111111",
			"11111111111111111111",
			"11111111111111111111"
		]
	},
	"wallLayer": {
		"ids": [
			"0_0"
		],
		"grid": [
			"11111110111111111111",
			"10000010000001000001",
			"10000010000001000001",
			"10000010000001000001",
			"11011110000001111011",
			"10000000000000000001",
			"10000000000000000001",
			"11111110000001111111",
			"10000010000001000001",
			"10000010000001000001",
			"10000010000001000001",
			"11011110111101111011",
			"10000000000000000001",
			"10000000000000000001",
			"10000000000000000001",
			"10000000000000000001",
			"10000000000000000001",
			"10000000000000000001",
			"10000000000000000001",
			"11111111111111111111"
		]
	},
	"attribLayer": {
		"ids": [
			"BLOCK",
			"OBJECT: door_skeleton_boss",
			"NPC: skeleton",
			"ITEM: pickaxe_crude",
			"OBJECT: torch_wall",
			"OBJECT: door_closed",
			"ITEM: coins",
			"OBJECT: ladder_dungeon"
		],
		"grid": [
			"11111112111111111111",
			"10000010011001000001",
			"10003010011001040001",
			"10000010011001000001",
			"15651110011001115651",
			"10000000011000000001",
			"10000000011000000001",
			"11111110011001111111",
			"10000010011001000001",
			"10007010011001030001",
			"10000010011001000001",
			"15651116111161115651",
			"10000000000000000001",
			"10000000300000000001",
			"10000000000000000001",
			"10003000000000000801",
			"10000000000000000001",
			"10000000000000000001",
			"10000000000000000001",
			"11111111111111111111"
		]
	},
	"decoLayer": {
		"ids": [
			"1_2",
			"4_2",
			"2_2"
		],
		"grid": [
			"00100000000000000000",
			"00000000000020000000",
			"00000000000000000300",
			"00000000000000000000",
			"00000000000000000000",
			"00000000002000000000",
			"00000000020000000000",
			"00000000000000000100",
			"00000000000000000000",
			"00000000000000000000",
			"00000000000000000000",
			"00000000000000000000",
			"00000000000000000000",
			"00200000000000200000",
			"00000000002000000000",
			"00000000000000000000",
			"00000000000030000000",
			"00000020000000000000",
			"00000000000000000000",
			"00000000000000000000"
		]
	}
}