{
	"width": 48,
	"height": 48,
	"ambient": null,
	"baseLayer": {
		"ids": [
			"GROUND_2_1",
			"WATER",
			"GROUND_1_2",
			"GROUND_0_0"
		],
		"grid": [
			"111111111111111111111111111111111111111111111111",
			"111111111111111111111111111111111111111111111111",
			"111111111111111111111111111111111111111111111111",
			"111111111111111111111111111111111111111111111111",
			"111111111111111111111111111111111111111111111111",
			"111111111111111111111122222211111111111111111111",
			"111111111111111111112222222222111111111111111111",
			"111111111111111111122222222222111111111111111111",
			"111111111111111111122222222222111111111111111111",
			"111111111111111111122222222222111111111111111111",
			"111111111111111111112222222221111111111111111111",
			"111111111111111111111222222211111111111111111111",
			"111111111111111111111111111111111111111111111113",
			"111111111111111111111111111111111111111111111113",
			"111111111111111111111111111111111111111111111113",
			"133111311111111111111111111111111111111111111113",
			"333333311111111111111111111111111111111111111133",
			"333333311111111111111111111111111111111111111133",
			"333331111111111111111111111111111111111111111333",
			"333111111111111111111111111111111111111111133333",
			"331111111111111111111111111111111111111111133331",
			"331111111111111111111111111111111111111111333311",
			"311111111111111111111111111111111111111111131111",
			"311111111111333311111111111111111111111111111111",
			"111111111111133311111111111111111111111111111111",
			"111111111111133333111111111111111111111111111111",
			"111111111111133333111111111111111111111111111111",
			"111111111111113333311111111111111111111111111111",
			"111111111111111133333311111111111111111111111111",
			"111111111111111111131111111114444111111111111111",
			"111111111111111111111111111114444111111111111111",
			"111111111111111111111111111444444111111111111111",
			"111111111111111111111111111444444111111111111111",
			"111111111111111111111111111444444111111111111111",
			"111111111111111111111111111111111111111111111111",
			"111111111111111111111111111111111111111111111111",
			"111111111111111111111111111111111111111111111111",
			"111111111111111111111111111111111111111111111111",
			"111111111111111111111111111111111111111114444444",
			"111111111111111111111111111111111111111114444444",
			"111111111111144111111111111111111111111114444444",
			"111111111114444111111111111111111111111111111144",
			"111111111114444111111111111111111111111111111144",
			"111111111111111111111111111111111111111111111111",
			"111111111111111111111111111111111111111111111111",
			"111111111111111111111111111111111111111111111111",
			"111111111111111111111111111111111111111111111111",
			"111111111111111111111111111111111111111111111111"
		]
	},
	"overLayer": {
		"ids": [
			"0_0_3_3",
			"0_0_1_5",
			"0_0_4_3",
			"0_0_2_5",
			"0_0_0_3",
			"0_0_1_3",
			"0_0_2_3",
			"0_0_0_5",
			"0_0_4_4",
			"0_0_3_4",
			"0_0_0_4",
			"0_0_2_4",
			"1_2_3_3",
			"1_2_2_5",
			"1_2_2_4",
			"1_2_1_5",
			"1_2_4_3",
			"1_2_0_5",
			"1_2_0_4",
			"1_2_0_3",
			"1_2_1_3",
			"1_2_4_4",
			"1_2_3_4",
			"1_2_2_3",
			"2_1_0_3",
			"2_1_1_3",
			"2_1_2_3",
			"2_1_0_4",
			"2_1_3_3",
			"2_1_4_0",
			"2_1_2_4",
			"2_1_4_4",
			"2_1_2_1",
			"2_1_0_1",
			"2_1_3_1",
			"2_1_0_5",
			"2_1_1_5",
			"2_1_2_5",
			"2_1_4_3"
		],
		"grid": [
			"000000000000000000000000000000000000000000000000000000000000000000000000000000000000000000000000",
			"000000000000000000000000000000000000000000000000000000000000000000000000000000000000000000000000",
			"000000000000000000000000000000000000000000000000000000000000000000000000000000000000000000000000",
			"000000000000000000000000000000000000000000000000000000000000000000000000000000000000000000000000",
			"000000000000000000000000000000000000000000010202020202020300000000000000000000000000000000000000",
			"000000000000000000000000000000000000000102040506060606070802030000000000000000000000000000000000",
			"000000000000000000000000000000000000010405060900000000100607110000000000000000000000000000000000",
			"000000000000000000000000000000000000120509000000000000000012110000000000000000000000000000000000",
			"000000000000000000000000000000000000121100000000000000000012110000000000000000000000000000000000",
			"000000000000000000000000000000000000120803000000000000000104110000000000000000000000000000000000",
			"000000000000000000000000000000000000100708030000000000010405090000000000000000000000000000000013",
			"000000000000000000000000000000000000001007080202020202040509000000000000000000000000000000001314",
			"000000000000000000000000000000000000000010060606060606060900000000000000000000000000000000001500",
			"000000000000000000000000000000000000000000000000000000000000000000000000000000000000000000001500",
			"131616170013161700000000000000000000000000000000000000000000000000000000000000000000000000001500",
			"140000181614001900000000000000000000000000000000000000000000000000000000000000000000000000131400",
			"000000000000001900000000000000000000000000000000000000000000000000000000000000000000000000150000",
			"000000000000001900000000000000000000000000000000000000000000000000000000000000000000000013140000",
			"000000000020212200000000000000000000000000000000000000000000000000000000000000000000131614000000",
			"000000202122000000000000000000000000000000000000000000000000000000000000000000000000150000000000",
			"000020220000000000000000000000000000000000000000000000000000000000000000000000000013140000000020",
			"000019000000000000000000000000000000000000000000000000000000000000000000000000001314000000002022",
			"002022000000000000000013161616161700000000000000000000000000000000000000000000002321240020212200",
			"001900000000000000000015000000001900000000000000000000000000000000000000000000000000000000000000",
			"202200000000000000000023240000001816170000000000000000000000000000000000000000000000000000000000",
			"000000000000000000000000150000000000190000000000000000000000000000000000000000000000000000000000",
			"000000000000000000000000150000000000181700000000000000000000000000000000000000000000000000000000",
			"000000000000000000000000232400000000001816161700000000000000000000000000000000000000000000000000",
			"000000000000000000000000000023240000000000001900000000000000000000000000000000000000000000000000",
			"000000000000000000000000000000232121240020212200000000000025262627000000000000000000000000000000",
			"000000000000000000000000000000000000232419000000000000000028293031000000000000000000000000000000",
			"000000000000000000000000000000000000002322000000000000252632333431000000000000000000000000000000",
			"000000000000000000000000000000000000000000000000000000280000353231000000000000000000000000000000",
			"000000000000000000000000000000000000000000000000000000363737373738000000000000000000000000000000",
			"000000000000000000000000000000000000000000000000000000000000000000000000000000000000000000000000",
			"000000000000000000000000000000000000000000000000000000000000000000000000000000000000000000000000",
			"000000000000000000000000000000000000000000000000000000000000000000000000000000000000000000000000",
			"000000000000000000000000000000000000000000000000000000000000000000000000000000000000000000000000",
			"000000000000000000000000000000000000000000000000000000000000000000000000000000000025262626262626",
			"000000000000000000000000000000000000000000000000000000000000000000000000000000000028000000000000",
			"000000000000000000000000002527000000000000000000000000000000000000000000000000000036373737373900",
			"000000000000000000000025263231000000000000000000000000000000000000000000000000000000000000002800",
			"000000000000000000000036373738000000000000000000000000000000000000000000000000000000000000003637",
			"000000000000000000000000000000000000000000000000000000000000000000000000000000000000000000000000",
			"000000000000000000000000000000000000000000000000000000000000000000000000000000000000000000000000",
			"000000000000000000000000000000000000000000000000000000000000000000000000000000000000000000000000",
			"000000000000000000000000000000000000000000000000000000000000000000000000000000000000000000000000",
			"000000000000000000000000000000000000000000000000000000000000000000000000000000000000000000000000"
		]
	},
	"attribLayer": {
		"ids": [
			"ISLAND",
			"OBJECT: cactus",
			"BLOCK",
			"WARP: newbie_east_route 81 45",
			"WARP: newbie_east_route 82 45",
			"OBJECT: tree_palm",
			"NPC: snake_weak",
			"OBJECT: ore_copper",
			"OBJECT: ore_iron",
			"OBJECT: rock_pointy",
			"NPC: scorpion",
			"OBJECT: rope",
			"OBJECT: ore_gold",
			"WARP: desert_maze_start 2 3"
		],
		"grid": [
			"010000000000000000000000000000000000000000000000000000000000000000000002000000030000030100000000",
			"000000000303030303030000000000000000030303030303030303030303030300000000000000030405030000000000",
			"000000030303030303030303030303030303030303030303030303030303030303030303030303030000030303000000",
			"000000030303030303030303030303030303030303030303030303030303030303030303030303030000030303030000",
			"000200030000000000000303030303030303000000000000000000000000000303030303030303030000030303030000",
			"000000030000000000000000000000000000000000000303030303030000000000000000000000000000000000030303",
			"030303030000000000000000000000060000000003030303030303030303000000000600000000000000000000030303",
			"030303030000000000000000000000000000000303030303030303030303000000000000000000000000000000030303",
			"030303030000000000000000000000000000000303030303030303030303000000000000000000000000000000000000",
			"000000000000000000000000000000000000000303030303030303030303000000000000000000000000000000000000",
			"000000000000060000000000030303030300000003030303030303030300000600000007000000000006000000020003",
			"000000000000000000000000030100000300000000030303030303030000000000000000000000000000000000000303",
			"000000000000000000000000030000000300000000000000000000000000000000000000000000000000000000000303",
			"000000000000000000000000030000000308000000000000000000000000000000000000000000000000000000000303",
			"030303030003030300000000030006000003030303030303030303000600000000000000000000000000000000000303",
			"030303030303030300000000030000000000000000000000000003000000000000000000000006000000070000030303",
			"030303030303030300000000030000000000000000000000020003000000000000070000000000000000000000030303",
			"030303030303030300000000030000000000000000000002000003000000000000000000000000000000000003030303",
			"030303030303000000000600030303030303030303000000000003000002000000000000000000000000030303030303",
			"030303030000000000000000030303030303030303030000000003000000000000000000000000000700030303030303",
			"030303000000000000000000000000000009000900030000000003000000000000000000020000000003030303030303",
			"030303000200000000000000000000000000000000030006000003000000000000000000000000000303030303030300",
			"030300000000000000000003030303030300000000030000000003000000000000000000000000000000030303000000",
			"030300000000000000000003030303030308000000030303030303000000000000070000000000000000000000000000",
			"030000100000000000000000030303030303030000030303030303000000000000000000000006000000000000000200",
			"000000000000000000000000030303030303030000000000000000000000000000000000000000000000000000000000",
			"000000000000000000060000030303030303030800000000000000000000000000000000000000000000000000000000",
			"000000000000000000000000000303030303030303030300000000000000000000000000000000000000060000000000",
			"000000000000000000000000000000030303030303030300000002000000000000000000000000000000000000000000",
			"000000000006000000000000000000000000030303030000000000000000000000000000000000000000000000000000",
			"000000000000000000000000000000000000000303000000000000000000000000000000000006000000000000000000",
			"000000000000000000000000000000000000000000000000000000000000000000000000000000000000000000000000",
			"000000000000000000000000000000000000000000000000000000000000000000000000000000000000000000000000",
			"000000000000000000000000000000000000000000000000000000000000000000000000000000000000000000000600",
			"000303030303030303030303030303030000000010000000000000000000000000000000000000000000000000000000",
			"030303030303030303030302010000030000000000000000000000000000000000000000000003030303030303030303",
			"030303030303030303030300000006030000000000000000000000000000000000000000020003000000000000000000",
			"030100000000000000000300000000030000000000000000000000000000000000000000000003000303030303030303",
			"030011000000000011000300000000030000000000030303030303030303030003030303030301000301000000000000",
			"030000000000000000000300000000030010000000030000000003030303030303030000000000000300000000000000",
			"030000001100000000000300000000030000000000030006000003030303031203030003030303030300000000000000",
			"030000000000000000000300000000000303030303000000000003000000000000030003130000000000000000000000",
			"030000000000000000000300000000000000000000000000000003000000000000030003030303030000000000000000",
			"030000000000110000000303030303030303030303030303030303000000000000030003030303030300000000000000",
			"030000000000000000000303030303030303030303030303030303000000000000030003030303030300000000000000",
			"030011000000000011000303030303030303030303030303030303000000001400030000000000000300000000000000",
			"030000000000000000000000000000000000000000000000000000000000000000030000000000000300000000000000",
			"030303030303030303030303030303030303030303030303030303030303030303000000000000000300000000000000"
		]
	},
	"decoLayer": {
		"ids": [
			"7_7",
			"5_7",
			"7_5",
			"6_8",
			"5_5",
			"4_0",
			"6_9",
			"5_8",
			"7_8",
			"6_10",
			"5_9",
			"7_9",
			"5_10",
			"7_10",
			"5_6",
			"6_6",
			"7_6",
			"7_11",
			"5_11",
			"0_2"
		],
		"grid": [
			"000000000000000000000000000000000000000000000000000000000000000000000000000000010000020000000000",
			"000000030404040404040500000000000003040404040404040404040404040500000000000000010606020000000000",
			"000000010707070707070804040404040409070707070707070707070707070804040404040404090000080404050000",
			"000000011010101010101107070707070712101010101010101010101010101107070707070707120000110707020000",
			"000000010000000000001310101010101014000000000000000000000000001310101010101010140000131010020000",
			"000000010000000000000000000000000000000000000000000000000000000000000000000000000000000000080404",
			"040404090000000000000000000000000000000000000000000000000000000000000000000000000000000000110707",
			"070707120000000000000000000000000000000000000000000000000000000000000000000000000000000000131010",
			"101010140000000000000000000000000000000000000000000000000000000000000000000000000000000000000000",
			"000000000000000000000000000000000000000000000000000000000000000000000000000000000000000000000000",
			"000000000000000000000000151616161700000000000000000000000000000000000000000000000000000000000000",
			"000000000000000000000000020000000100000000000000000000000000000000000000000000000000000000000000",
			"000000000000000000000000020000000100000000000000000000000000000000000000000000000000000000000000",
			"000000000000000000000000020000000100000000000000000000000000000000000000000000000000000000000000",
			"000000000000000000000000020000001816161616161616161617000000000000000000000000000000000000000000",
			"000000000000000000000000020000000000000000000000000001000000000000000000000000000000000000000000",
			"000000000000000000000000020000000000000000000000000001000000000000000000000000000000000000000000",
			"000000000000000000000000020000000000000000000000000001000000000000000000000000000000000000000000",
			"000000000000000000000000080404040404040404050000000001000000000000000000000000000000000000000000",
			"000000000000000000000000131010101010101010020000000001000000000000000000000000000000000000000000",
			"000000000000000000000000000000000000000000020000000001000000000000000000000000000000000000000000",
			"000000000000000000000000000000000000000000020000000001000000000000000000000000000000000000000000",
			"000000000000000000000000000000000000000000020000000001000000000000000000000000000000000000000000",
			"000000000000000000000000000000000000000000080404040409000000000000000000000000000000000000000000",
			"000000000000000000000000000000000000000000131010101014000000000000000000000000000000000000000000",
			"000000000000000000000000000000000000000000000000000000000000000000000000000000000000000000000000",
			"000000000000000000000000000000000000000000000000000000000000000000000000000000000000000000000000",
			"000000000000000000000000000000000000000000000000000000000000000000000000000000000000000000000000",
			"000000000000000000000000000000000000000000000000000000000000000000000000000000000000000000000000",
			"000000000000000000000000000000000000000000000000000000000000000000000000000000000000000000000000",
			"000000000000000000000000000000000000000000000000000000000000000000000000000000000000000000000000",
			"000000000000000000000000000000000000000000000000000000000000000000000000000000000000000000000000",
			"000000000000000000000000000000000000000000000000000000000000000000000000000000000000000000000000",
			"000000000000000000000000000000000000000000000000000000000000000000000000000000000000000000000000",
			"030404040404040404041516161616170000000000000000000000000000000000000000000000000000000000000000",
			"010707070707070707070200000000010000000000000000000000000000000000000000000015161616161616161616",
			"011010101010101010100200000000010000000000000000000000000000000000000000000002000000000000000000",
			"010000000000000000000200000000010000000000000000000000000000000000000000000002001516161616161616",
			"010000000000000000000200000000010000000000151616161617040404040404151616161619000200000000000000",
			"010000000000000000000200000000010000000000020000000001070707070707020000000000000200000000000000",
			"010000000000000000000200000000010000000000020000000001101010101010020015161616161900000000000000",
			"010000000000000000000200000000181616161616190000000001000000000000020002000000000000000000000000",
			"010000000000000000000200000000000000000000000000000001000000000000020008040404040500000000000000",
			"010000000000000000000804040404040404040404040404040409000000000000020011070707070200000000000000",
			"010000000000000000001107070707070707070707070707070712000000000000020013101010100200000000000000",
			"010000000000000000001310101010101010101010101010101014000000002000020000000000000200000000000000",
			"010000000000000000000000000000000000000000000000000000000000000000020000000000000200000000000000",
			"001616161616161616161616161616161616161616161616161616161616161616000000000000000200000000000000"
		]
	}
}