{
	"width": 48,
	"height": 48,
	"ambient": null,
	"baseLayer": {
		"ids": [
			"GROUND_2_1",
			"WATER"
		],
		"grid": [
			"111111111111111111111111111111111111111111111111",
			"111111111111111111111111111111111111111111111111",
			"111111111111111111111111111111111111111111111111",
			"111111111111111111111111111111111111111111111111",
			"111111111111111111111111111111111111111111111111",
			"111111111111111111111122222211111111111111111111",
			"111111111111111111112222222222111111111111111111",
			"111111111111111111122222222222111111111111111111",
			"111111111111111111122222222222111111111111111111",
			"111111111111111111122222222222111111111111111111",
			"111111111111111111112222222221111111111111111111",
			"111111111111111111111222222211111111111111111111",
			"111111111111111111111111111111111111111111111111",
			"111111111111111111111111111111111111111111111111",
			"111111111111111111111111111111111111111111111111",
			"111111111111111111111111111111111111111111111111",
			"111111111111111111111111111111111111111111111111",
			"111111111111111111111111111111111111111111111111",
			"111111111111111111111111111111111111111111111111",
			"111111111111111111111111111111111111111111111111",
			"111111111111111111111111111111111111111111111111",
			"111111111111111111111111111111111111111111111111",
			"111111111111111111111111111111111111111111111111",
			"111111111111111111111111111111111111111111111111",
			"111111111111111111111111111111111111111111111111",
			"111111111111111111111111111111111111111111111111",
			"111111111111111111111111111111111111111111111111",
			"111111111111111111111111111111111111111111111111",
			"111111111111111111111111111111111111111111111111",
			"111111111111111111111111111111111111111111111111",
			"111111111111111111111111111111111111111111111111",
			"111111111111111111111111111111111111111111111111",
			"111111111111111111111111111111111111111111111111",
			"111111111111111111111111111111111111111111111111",
			"111111111111111111111111111111111111111111111111",
			"111111111111111111111111111111111111111111111111",
			"111111111111111111111111111111111111111111111111",
			"111111111111111111111111111111111111111111111111",
			"111111111111111111111111111111111111111111111111",
			"111111111111111111111111111111111111111111111111",
			"111111111111111111111111111111111111111111111111",
			"111111111111111111111111111111111111111111111111",
			"111111111111111111111111111111111111111111111111",
			"111111111111111111111111111111111111111111111111",
			"111111111111111111111111111111111111111111111111",
			"111111111111111111111111111111111111111111111111",
			"111111111111111111111111111111111111111111111111",
			"111111111111111111111111111111111111111111111111"
		]
	},
	"overLayer": {
		"ids": [
			"2_1_0_0",
			"2_1_1_0",
			"2_1_2_0",
			"2_1_4_1",
			"2_1_3_1",
			"2_1_2_1",
			"2_1_0_1",
			"2_1_0_2",
			"2_1_4_0",
			"2_1_3_0",
			"2_1_2_2",
			"2_1_1_2"
		],
		"grid": [
			"000000000000000000000000000000000000000000000000000000000000000000000000000000000000000000000000",
			"000000000000000000000000000000000000000000000000000000000000000000000000000000000000000000000000",
			"000000000000000000000000000000000000000000000000000000000000000000000000000000000000000000000000",
			"000000000000000000000000000000000000000000000000000000000000000000000000000000000000000000000000",
			"000000000000000000000000000000000000000000000000000000000000000000000000000000000000000000000000",
			"000000000000000000000000000000000000000000000102020202030000000000000000000000000000000000000000",
			"000000000000000000000000000000000000000001020400000000050203000000000000000000000000000000000000",
			"000000000000000000000000000000000000000104000000000000000006000000000000000000000000000000000000",
			"000000000000000000000000000000000000000700000000000000000006000000000000000000000000000000000000",
			"000000000000000000000000000000000000000809000000000000001011000000000000000000000000000000000000",
			"000000000000000000000000000000000000000008090000000000101100000000000000000000000000000000000000",
			"000000000000000000000000000000000000000000081212121212110000000000000000000000000000000000000000",
			"000000000000000000000000000000000000000000000000000000000000000000000000000000000000000000000000",
			"000000000000000000000000000000000000000000000000000000000000000000000000000000000000000000000000",
			"000000000000000000000000000000000000000000000000000000000000000000000000000000000000000000000000",
			"000000000000000000000000000000000000000000000000000000000000000000000000000000000000000000000000",
			"000000000000000000000000000000000000000000000000000000000000000000000000000000000000000000000000",
			"000000000000000000000000000000000000000000000000000000000000000000000000000000000000000000000000",
			"000000000000000000000000000000000000000000000000000000000000000000000000000000000000000000000000",
			"000000000000000000000000000000000000000000000000000000000000000000000000000000000000000000000000",
			"000000000000000000000000000000000000000000000000000000000000000000000000000000000000000000000000",
			"000000000000000000000000000000000000000000000000000000000000000000000000000000000000000000000000",
			"000000000000000000000000000000000000000000000000000000000000000000000000000000000000000000000000",
			"000000000000000000000000000000000000000000000000000000000000000000000000000000000000000000000000",
			"000000000000000000000000000000000000000000000000000000000000000000000000000000000000000000000000",
			"000000000000000000000000000000000000000000000000000000000000000000000000000000000000000000000000",
			"000000000000000000000000000000000000000000000000000000000000000000000000000000000000000000000000",
			"000000000000000000000000000000000000000000000000000000000000000000000000000000000000000000000000",
			"000000000000000000000000000000000000000000000000000000000000000000000000000000000000000000000000",
			"000000000000000000000000000000000000000000000000000000000000000000000000000000000000000000000000",
			"000000000000000000000000000000000000000000000000000000000000000000000000000000000000000000000000",
			"000000000000000000000000000000000000000000000000000000000000000000000000000000000000000000000000",
			"000000000000000000000000000000000000000000000000000000000000000000000000000000000000000000000000",
			"000000000000000000000000000000000000000000000000000000000000000000000000000000000000000000000000",
			"000000000000000000000000000000000000000000000000000000000000000000000000000000000000000000000000",
			"000000000000000000000000000000000000000000000000000000000000000000000000000000000000000000000000",
			"000000000000000000000000000000000000000000000000000000000000000000000000000000000000000000000000",
			"000000000000000000000000000000000000000000000000000000000000000000000000000000000000000000000000",
			"000000000000000000000000000000000000000000000000000000000000000000000000000000000000000000000000",
			"000000000000000000000000000000000000000000000000000000000000000000000000000000000000000000000000",
			"000000000000000000000000000000000000000000000000000000000000000000000000000000000000000000000000",
			"000000000000000000000000000000000000000000000000000000000000000000000000000000000000000000000000",
			"000000000000000000000000000000000000000000000000000000000000000000000000000000000000000000000000",
			"000000000000000000000000000000000000000000000000000000000000000000000000000000000000000000000000",
			"000000000000000000000000000000000000000000000000000000000000000000000000000000000000000000000000",
			"000000000000000000000000000000000000000000000000000000000000000000000000000000000000000000000000",
			"000000000000000000000000000000000000000000000000000000000000000000000000000000000000000000000000",
			"000000000000000000000000000000000000000000000000000000000000000000000000000000000000000000000000"
		]
	},
	"wallLayer": {
		"ids": [
			"4_0"
		],
		"grid": [
			"111111111111111111111111111111111111111000011111",
			"111000111111111111101111110011111111000000001111",
			"100000001111001000100011110000011110000000000111",
			"000000000000000000000000000000000000000000000001",
			"000000000000000000000000000000000000000000000000",
			"000000000000000000000000000000000000000000000000",
			"000000000000000000000000000000000000000000000000",
			"000000000000000000000000000000000000000000000000",
			"000000000000011110000000000000000000000000000000",
			"000000000000111110000000000000000000000000000001",
			"000000000001111100000000000000000000000000000001",
			"000000000001111100000000000000000000000000000011",
			"000000000000111000000000000000000000000000000011",
			"000000000000111100000000000000000000000000000011",
			"000000000000011111111110000000000000000000000111",
			"110000000000011111111111100000000000000000000111",
			"111000000000011111111111111000000000000000001111",
			"111111000000011111111111111100000000000000001111",
			"111111000000011111111111111110000000000000011111",
			"111100000000011111111111111111000000000000011110",
			"111100000000001111111111111111000000000000011110",
			"111000000000000111111111111111100000000000111000",
			"111000000000000011111111111111100000000000110000",
			"110000000000000011111111111111100000000000000000",
			"110000000000000111111111111111100000000000000000",
			"100000000000000110001111111111100000000000000000",
			"100000000000000000000001111111100000000000000000",
			"000000000000000000000000011111100000000000000000",
			"000000000000000000000000001111000000000000000001",
			"000000000000000000010000001110000000000000000011",
			"000000000000000000111000011100000000000000000011",
			"000000000000000000010000000000000000000000000111",
			"000000000000000000000000000000000000000000000111",
			"000000000000000000000000000000000000000000000111",
			"000000000000000000000000000000000000000000001111",
			"000000000000000000000000000000000000000000001111",
			"000000000000000000000000000000000000000000011111",
			"000000000000000000000000000000000000000000011111",
			"000000000000000000000000000000000000000000011111",
			"000000000000000000000000000000000000000000000111",
			"000000000000000000000000000000000000000000000111",
			"000000000011100000100000000001000000000000000011",
			"110010000011100000110000000001100000001100000011",
			"111111000111100001111000000011100000111100000011",
			"111111111111110011111100000111110001111110000011",
			"111111111111110011111110001111110111111111000111",
			"111111111111111111111111011111111111111111111111",
			"111111111111111111111111111111111111111111111111"
		]
	},
	"attribLayer": {
		"ids": [
			"BLOCK",
			"WARP: newbie_east_route 81 45",
			"WARP: newbie_east_route 82 45",
			"OBJECT: tree_palm",
			"NPC: snake_weak",
			"OBJECT: ore_copper",
			"OBJECT: ore_iron",
			"NPC: scorpion",
			"WARP: desert_maze_start 2 3"
		],
		"grid": [
			"111111111111111111111111111111111111111000011111",
			"111000111111111111101111110011111111000023001111",
			"100000001111001000100011110000011110000000000111",
			"000000000000000000000000000000000000000000000001",
			"000000000000000000000000000000000000000000000000",
			"000000000000000000000011111100000000000000000000",
			"000000000000000400001111111111000040000000000000",
			"000000000000000000011111111111000000000000000000",
			"000000000000011110011111111111000000000000000000",
			"000000000000111110011111111111000000000000000001",
			"000000400001111100001111111110040005000004000001",
			"000000000001111100000111111100000000000000000011",
			"000000000000111006000000000000000000000000000011",
			"000000000000111100000000000000000000000000000011",
			"000000000000011111111110000040000000000000000111",
			"110000000000011111111111100000000000004000500111",
			"111000000000011111111111111000000500000000001111",
			"111111000000011111111111111100000000000000001111",
			"111111000040011111111111111110000000000000011111",
			"111100000000011111111111111111000000000050011110",
			"111100000000001111111111111111000000400000011110",
			"111000000000000111111111111111100000000000111000",
			"111000000000000011111111111111100000000000110000",
			"110000000000000011111111111111100500000000000000",
			"110000000000000111111111111111100000004000000000",
			"100000000000000110001111111111100000000000000000",
			"100000000000000000700001111111100000000000000000",
			"000008000000000000000700011111100000000000000000",
			"000000000000000000000006001111000000000000000001",
			"000000000000000000010000001110000000000000000011",
			"000000000000008000111000011100000000004000000011",
			"000000000000000000010000000000000000000000000111",
			"080000000000000000000000000000000000000000000111",
			"000000000000000000000000000000000000000000000111",
			"000000008000000000000000000000000004000000001111",
			"000000000000000000000000000000000000000000001111",
			"000000000000000000000000000000000000000000011111",
			"000000000000008000000000000000000000000000011111",
			"000800000000000000000000000000040000000000011111",
			"000000000000000000000000000000000000000000000111",
			"000000000000000000000000000000000000000000000111",
			"000000000011100000100000000001000000000000000011",
			"110010000011100000110000000001100000001100000011",
			"111111000111100001111000000011100000111100000011",
			"111111111111110011111100900111110001111110000011",
			"111111111111110011111110001111110111111111000111",
			"111111111111111111111111011111111111111111111111",
			"111111111111111111111111111111111111111111111111"
		]
	},
	"decoLayer": {
		"ids": [
			"4_0",
			"0_2"
		],
		"grid": [
			"000000000000000000000000000000000000000000000000",
			"000000000000000000000000000000000000000011000000",
			"000000000000000000000000000000000000000000000000",
			"000000000000000000000000000000000000000000000000",
			"000000000000000000000000000000000000000000000000",
			"000000000000000000000000000000000000000000000000",
			"000000000000000000000000000000000000000000000000",
			"000000000000000000000000000000000000000000000000",
			"000000000000000000000000000000000000000000000000",
			"000000000000000000000000000000000000000000000000",
			"000000000000000000000000000000000000000000000000",
			"000000000000000000000000000000000000000000000000",
			"000000000000000000000000000000000000000000000000",
			"000000000000000000000000000000000000000000000000",
			"000000000000000000000000000000000000000000000000",
			"000000000000000000000000000000000000000000000000",
			"000000000000000000000000000000000000000000000000",
			"000000000000000000000000000000000000000000000000",
			"000000000000000000000000000000000000000000000000",
			"000000000000000000000000000000000000000000000000",
			"000000000000000000000000000000000000000000000000",
			"000000000000000000000000000000000000000000000000",
			"000000000000000000000000000000000000000000000000",
			"000000000000000000000000000000000000000000000000",
			"000000000000000000000000000000000000000000000000",
			"000000000000000000000000000000000000000000000000",
			"000000000000000000000000000000000000000000000000",
			"000000000000000000000000000000000000000000000000",
			"000000000000000000000000000000000000000000000000",
			"000000000000000000000000000000000000000000000000",
			"000000000000000000000000000000000000000000000000",
			"000000000000000000000000000000000000000000000000",
			"000000000000000000000000000000000000000000000000",
			"000000000000000000000000000000000000000000000000",
			"000000000000000000000000000000000000000000000000",
			"000000000000000000000000000000000000000000000000",
			"000000000000000000000000000000000000000000000000",
			"000000000000000000000000000000000000000000000000",
			"000000000000000000000000000000000000000000000000",
			"000000000000000000000000000000000000000000000000",
			"000000000000000000000000000000000000000000000000",
			"000000000000000000000000000000000000000000000000",
			"000000000000000000000000000000000000000000000000",
			"000000000000000000000000000000000000000000000000",
			"000000000000000000000000200000000000000000000000",
			"000000000000000000000000000000000000000000000000",
			"000000000000000000000000000000000000000000000000",
			"000000000000000000000000000000000000000000000000"
		]
	}
}