{
	"width": 16,
	"height": 16,
	"ambient": [
		0.5,
		0.5,
		0.5
	],
	"baseLayer": {
		"ids": [
			"GROUND_2_1"
		],
		"grid": [
			"1111111111111111",
			"1111111111111111",
			"1111111111111111",
			"1111111111111111",
			"1111111111111111",
			"1111111111111111",
			"1111111111111111",
			"1111111111111111",
			"1111111111111111",
			"1111111111111111",
			"1111111111111111",
			"1111111111111111",
			"1111111111111111",
			"1111111111111111",
			"1111111111111111",
			"1111111111111111"
		]
	},
	"wallLayer": {
		"ids": [
			"4_0"
		],
		"grid": [
			"1111111111111111",
			"1100000000000011",
			"1000000000010001",
			"1001110000111001",
			"1001100000011001",
			"1001000000000001",
			"1000000000000001",
			"1000000011100001",
			"1000000111000001",
			"1000000000000001",
			"1000000000001001",
			"1001100000011001",
			"1001110000011001",
			"1000000000000001",
			"1100000000000011",
			"1111111001111111"
		]
	},
	"attribLayer": {
		"ids": [
			"BLOCK",
			"OBJECT: torch_wall",
			"OBJECT: ore_gold",
			"TRIGGER: exit_maze_mine"
		],
		"grid": [
			"1112111111112111",
			"1100000000000011",
			"1000000000010001",
			"1001110000111001",
			"1001200000011001",
			"1001003000000001",
			"1000000000000001",
			"1000000011100001",
			"1000000112000001",
			"1030000000000001",
			"1000000030001001",
			"1001200000011001",
			"1001110000011001",
			"1000000000000001",
			"1100000000000011",
			"1111111441111111"
		]
	},
	"decoLayer": {
		"ids": [
			"4_0"
		],
		"grid": [
			"0000000000000000",
			"0000000000000000",
			"0000000000000000",
			"0000000000000000",
			"0000000000000000",
			"0000000000000000",
			"0000000000000000",
			"0000000000000000",
			"0000000000000000",
			"0000000000000000",
			"0000000000000000",
			"0000000000000000",
			"0000000000000000",
			"0000000000000000",
			"0000000000000000",
			"0000000110000000"
		]
	}
}