{
	"width": 48,
	"height": 48,
	"ambient": null,
	"baseLayer": {
		"ids": [
			"GROUND_0_0",
			"GROUND_1_0",
			"GROUND_2_0",
			"GROUND_2_1",
			"WATER"
		],
		"grid": [
			"111111111111111111111111111111111111111111111111",
			"111111111111111111111111111111111111111111111111",
			"111111111111111111111111111111111111111111111111",
			"111111111111111111111111112221111111111111111111",
			"111111333311111111111111112221113333333333331111",
			"111113333311111111111111112221113333333333331111",
			"111113333311111111111111112221113333333333331111",
			"111113333311111111111111112221133333333333331111",
			"111111333111111111111111112221133333333333331111",
			"111111111111111111111111112221113333333333331111",
			"111111111111111111111111112221113333333333331111",
			"111111111111111111111111112221113333333333331111",
			"111111111111111111111111112221111111133111111111",
			"111111111111111111111111112221111111111111111111",
			"111111111111111111111111112221111111111111111111",
			"111111111111111111111111112221111111111111111111",
			"111111111111111111111111112221111111111111111444",
			"111111111111111111111111111111111111111111444444",
			"111111111111111111111111111111111111111114444445",
			"111111111111111111111111111111111111111444445555",
			"111111111111111111111111111111111111111444555555",
			"111111111111111111111112221111111111111445555555",
			"111111111111111111111112221111111111111445555555",
			"111111111111111111111112221111111111111445555555",
			"111111111111111111111112221111111111111445555555",
			"111111111122222222222222221111111111111445555555",
			"111111111122222222222222221111111111111445555555",
			"111111111122222222222222221111111111144445555555",
			"111111111122211111111111111111111111444445555555",
			"111111111122211111111111111111111444444445555555",
			"111111111122211111111111111111144444444455555555",
			"111111111122211111111111111114444444444455555555",
			"111111111122211111111111111114444455555555555555",
			"111111111122211111111111111144455555555555555555",
			"111111111122211111111111111444555555555555555555",
			"111111111122211111111111111445555555555555555555",
			"111111111122211111111111114445555555555555555555",
			"111111111122211111111111114455555555555555555555",
			"111111111122211111111111144555555555555555555555",
			"111111111122211111111111444555555555555555555555",
			"111111111122211111111114445555555555555555555555",
			"111111111122211111111144455555555555555555555555",
			"111111111122211111111144555555555555555555555555",
			"111111111122211111111444555555555555555555555555",
			"111111111111111111111445555555555555555555555555",
			"111111111111111111111445555555555555555555555555",
			"111111111111111111111445555555555555555555555555",
			"111111111111111111111445555555555555555555555555"
		]
	},
	"overLayer": {
		"ids": [
			"0_0_0_0",
			"0_0_1_0",
			"0_0_2_0",
			"0_0_0_3",
			"0_0_1_3",
			"0_0_2_3",
			"0_0_0_1",
			"0_0_2_1",
			"0_0_4_4",
			"0_0_2_4",
			"0_0_0_4",
			"2_0_3_3",
			"2_0_2_5",
			"0_0_0_5",
			"0_0_4_3",
			"0_0_3_3",
			"0_0_2_5",
			"2_0_2_4",
			"0_0_1_5",
			"2_0_3_4",
			"2_0_2_3",
			"2_0_0_3",
			"2_0_1_3",
			"2_0_4_4",
			"0_0_0_2",
			"0_0_1_2",
			"0_0_2_2",
			"0_0_4_1",
			"2_1_0_0",
			"2_1_1_0",
			"2_1_4_1",
			"2_1_0_1",
			"0_0_3_0"
		],
		"grid": [
			"000000000000000000000000000000000000000000000000000000000000000000000000000000000000000000000000",
			"000000000000000000000000000000000000000000000000000000000000000000000000000000000000000000000000",
			"000000000000000000000000000000000000000000000000000000000000000000000000000000000000000000000000",
			"000000000000000000000000000000000000000000000000000001020300000000000000000000000000000000000000",
			"000000000000040505060000000000000000000000000000000007000800000000000000000000000000000000000000",
			"000000000004090000100000000000000000000000000000000007000800000000000000000000000000000000000000",
			"000000000011000000100000000000000000000000000000000007000800121300000000000000000000000000000000",
			"000000000014150016170000000000000000000000000000000007000800180000000000000000000000000000000000",
			"000000000000141917000000000000000000000000000000000007000800180000000000000000000000000000000000",
			"000000000000000000000000000000000000000000000000000007000800202100000000000000000000000000000000",
			"000000000000000000000000000000000000000000000000000007000800000000000000000000000000000000000000",
			"000000000000000000000000000000000000000000000000000007000800000000000000000000000000000000000000",
			"000000000000000000000000000000000000000000000000000007000800000000000000210000220000000000000000",
			"000000000000000000000000000000000000000000000000000007000800000000000000202323240000000000000000",
			"000000000000000000000000000000000000000000000000000007000800000000000000000000000000000000000000",
			"000000000000000000000000000000000000000000000000000007000800000000000000000000000000000000000000",
			"000000000000000000000000000000000000000000000000000025262700000000000000000000000000000000010202",
			"000000000000000000000000000000000000000000000000000000000000000000000000000000000000010202280000",
			"000000000000000000000000000000000000000000000000000000000000000000000000000000000001280000000029",
			"000000000000000000000000000000000000000000000000000000000000000000000000000000010228000029303031",
			"000000000000000000000000000000000000000000000000000000000000000000000000000000070000293031000000",
			"000000000000000000000000000000000000000000000001020300000000000000000000000000070029310000000000",
			"000000000000000000000000000000000000000000000007000800000000000000000000000000070032000000000000",
			"000000000000000000000000000000000000000000000007000800000000000000000000000000070032000000000000",
			"000000000000000000000000000000000000000000000007000800000000000000000000000000070032000000000000",
			"000000000000000000000102020202020202020202020228000800000000000000000000000000070032000000000000",
			"000000000000000000000700000000000000000000000000000800000000000000000000000000070032000000000000",
			"000000000000000000000700332626262626262626262626262700000000000000000000000102280032000000000000",
			"000000000000000000000700080000000000000000000000000000000000000000000000012800000032000000000000",
			"000000000000000000000700080000000000000000000000000000000000000000010202280000000032000000000000",
			"000000000000000000000700080000000000000000000000000000000000000102280000000000002931000000000000",
			"000000000000000000000700080000000000000000000000000000000001022800000000000000003200000000000000",
			"000000000000000000000700080000000000000000000000000000000007000000002930303030303100000000000000",
			"000000000000000000000700080000000000000000000000000000000128002930303100000000000000000000000000",
			"000000000000000000000700080000000000000000000000000000012800293100000000000000000000000000000000",
			"000000000000000000000700080000000000000000000000000000070029310000000000000000000000000000000000",
			"000000000000000000000700080000000000000000000000000001280032000000000000000000000000000000000000",
			"000000000000000000000700080000000000000000000000000007002931000000000000000000000000000000000000",
			"000000000000000000000700080000000000000000000000000128293100000000000000000000000000000000000000",
			"000000000000000000000700080000000000000000000000012800320000000000000000000000000000000000000000",
			"000000000000000000000700080000000000000000000001280029310000000000000000000000000000000000000000",
			"000000000000000000000700080000000000000000000128002931000000000000000000000000000000000000000000",
			"000000000000000000000700080000000000000000000700293100000000000000000000000000000000000000000000",
			"000000000000000000002526270000000000000000012800320000000000000000000000000000000000000000000000",
			"000000000000000000000000000000000000000000070029310000000000000000000000000000000000000000000000",
			"000000000000000000000000000000000000000000070032000000000000000000000000000000000000000000000000",
			"000000000000000000000000000000000000000000070032000000000000000000000000000000000000000000000000",
			"000000000000000000000000000000000000000000070032000000000000000000000000000000000000000000000000"
		]
	},
	"wallLayer": {
		"ids": [
			"1_0"
		],
		"grid": [
			"000000000000000000000000000000000000000000000000",
			"000000000000000000000000000000000000000000000000",
			"000000000000000000000000000000000000000000000000",
			"000000000000000000000000000000000000000000000000",
			"000000000000000000000000000000001111111111110000",
			"000000000000000000000000000000001000000000010000",
			"000000000000000000000000000000001000000000010000",
			"000000000000000000000000000000000000000000010000",
			"000000000000000000000000000000000000000000010000",
			"000000000000000000000000000000001000000000010000",
			"000000000000000000000000000000001000000000010000",
			"000000000000000000000000000000001111100111110000",
			"000000000000000000000000000000000000000000000000",
			"000000000000000000000000000000000000000000000000",
			"000000000000000000000000000000000000000000000000",
			"000000000000000000000000000000000000000000000000",
			"000000000000000000000000000000000000000000000000",
			"000000000000000000000000000000000000000000000000",
			"000000000000000000000000000000000000000000000000",
			"000000000000000000000000000000000000000000000000",
			"000000000000000000000000000000000000000000000000",
			"000000000000000000000000000000000000000000000000",
			"000000000000000000000000000000000000000000000000",
			"000000000000000000000000000000000000000000000000",
			"000000000000000000000000000000000000000000000000",
			"000000000000000000000000000000000000000000000000",
			"000000000000000000000000000000000000000000000000",
			"000000000000000000000000000000000000000000000000",
			"000000000000000000000000000000000000000000000000",
			"000000000000000000000000000000000000000000000000",
			"000000000000000000000000000000000000000000000000",
			"000000000000000000000000000000000000000000000000",
			"000000000000000000000000000000000000000000000000",
			"000000000000000000000000000000000000000000000000",
			"000000000000000000000000000000000000000000000000",
			"000000000000000000000000000000000000000000000000",
			"000000000000000000000000000000000000000000000000",
			"000000000000000000000000000000000000000000000000",
			"000000000000000000000000000000000000000000000000",
			"000000000000000000000000000000000000000000000000",
			"000000000000000000000000000000000000000000000000",
			"000000000000000000000000000000000000000000000000",
			"000000000000000000000000000000000000000000000000",
			"000000000000000000000000000000000000000000000000",
			"000000000000000000000000000000000000000000000000",
			"000000000000000000000000000000000000000000000000",
			"000000000000000000000000000000000000000000000000",
			"000000000000000000000000000000000000000000000000"
		]
	},
	"attribLayer": {
		"ids": [
			"BLOCK",
			"OBJECT: tree_common",
			"NPC: slime_weak",
			"WARP: newbie_cave_entrance 18 20",
			"OBJECT: tree_birch",
			"OBJECT: anvil",
			"OBJECT: furnace",
			"NPC_AVOID",
			"OBJECT: crate_small",
			"OBJECT: car",
			"ISLAND",
			"NPC: red_slime",
			"WARP: newbie_capital 2 15",
			"WARP: newbie_capital 2 16",
			"OBJECT: bush",
			"WARP: newbie_capital 2 17",
			"OBJECT: bush_strawberry",
			"OBJECT: tree_apple",
			"OBJECT: fishing_spot",
			"WARP: newbie_village 11 2",
			"WARP: newbie_village 12 2"
		],
		"grid": [
			"000000000000000000000000000000000000000000000000000100000000000000000000000000000000000000000000",
			"010101010101010101010101010000000000000000000000000101010101010101010101010101010101010101010100",
			"010101010101010101010101010000000200000000000000000100000000000000000000000000000000000000000100",
			"000000000000000000000000010000000000000000000000000100000000000000000000000000000000000000000100",
			"000200000300000000000200010000000000000000000000000100000000000001010101010101010101010100000100",
			"000000000000000004000000010002000000000500000000000100000000000001000000000000000000000100000100",
			"000300000000000000000000010000000000000000000000000100000000000001000600060000000700000100000100",
			"000000020000000000000000010000000000000000000500000100000000000008000000000000000000000100000100",
			"000000000000000000000000010000010101010000000000000100000000000008000000000000000000000100000100",
			"000200000002000000000200010000010002010000000000000100000000000001000000000000090000000100000100",
			"000000000101010101010101010101010000010000000000000100000000000001000000000000000000000100000100",
			"010101080100000000000010000000000000010000000000110100000000000001010101010808010101010100000100",
			"000100000100050000050000000002000000010001010101010100000000000000000000000000000000000000000100",
			"000100000100000000000000000000001101010001010101010100000000000000000000000000000000000000000100",
			"000100000101010101010101010101010101000001000000000000000000000000000000000012000000000000000100",
			"000100000101010101010101010101010101000001000000000000000000000200000000120000000000000000001300",
			"000100000101010101010101010000000000000001000200000000000000000000000000000000000200000000001400",
			"000100000101010101010101010015000000000001000000000000000000000000000000000000000000000000001600",
			"000100000000000000000000010000000000000001000000001200000000000000001500000000000000000000170001",
			"000100000000000000020000010000000015000001000000000000000000000000000000000000000000000001010101",
			"000100000000000000000000010000000000000001000000000000001200180000000000000000000000010101000000",
			"000100000000020000000000010101010101010101000000000000000000000000000000000000000001010000000000",
			"000100000000000000000000010101010101010101000000000000000000000000001800000000000001000000000000",
			"000100000000000000000000170017000017001700000000000000000000000000000000000000000001000000000000",
			"000100000000000000000000000000000000000000000000000000000000000000000000000000000001000000000000",
			"000100000000000002000000000000000000000000000000000000020000001800000000000000000001000000000000",
			"000100000000000000000000000000000000000000000000000000000000000000000000000000000001000000000000",
			"000100000000000000000000000000000000000000000000000000000000000000000000000000000001000000000000",
			"000100000000000000000000000000000000000200000000000000000015000000000000000000000001000000000000",
			"000100000000000000000000000000000000000000000000000000000000000000000000000000000001000000000000",
			"000100000200000000000000000002000000000300000000020000000000000000000000000000000101000000000000",
			"000100000000000000000000000000000000000000000000000000000000000000000000000000000100000000000000",
			"000100000000000000000000000000000000000000000000000000000000000000000100000000000100000000000000",
			"000100000000000000000000000000000015000000000000000000000000000101010119011901190100000000000000",
			"000100000000000200000000000000000000000000000000030000000000010100000101010101010100000000000000",
			"000100000000000000000000000000000000000000000000000000000001010000000000000000000000000000000000",
			"000100000000000000000000000000000000000000000300000000000001000000000000000000000000000000000000",
			"000100000000000000000000000000000000020000000000000000000101000000000000000000000000000000000000",
			"000100000000000000000000000000000000000000000000000000010100000000000000000000000000000000000000",
			"000100000200000000000000000000000000000000000000000000010000000000001100000000000000000000000000",
			"000100000000000000000000000000000000000000000000000001010000000000000000000000000000000000000000",
			"000100000000000000000000000000020000000000000000000101000000000000000000000000000000000000000000",
			"000100000000000200000000000000000000000000000000010100000000000000000000000000000000000000000000",
			"000100000000000000000000000000000000000000000000010000000000000000000000000000000000000000000000",
			"000100000000000000000000000000000000000000000001010000000000000000000000000000000000000000000000",
			"000100000000000000000000000000000000000000000001000000000000000000000000000000000000000000000000",
			"000101010101010101010120210101010101010101010101000000000000000000000000000000000000000000000000",
			"000000000000000000000000000000000000000000000001000000000000000000000000000000000000000000000000"
		]
	},
	"decoLayer": {
		"ids": [
			"7_1",
			"6_2",
			"5_1",
			"1_0",
			"2_0",
			"1_6",
			"2_6",
			"2_7",
			"6_4",
			"3_2",
			"0_7",
			"3_0",
			"0_2",
			"5_0",
			"6_0",
			"7_0",
			"0_0",
			"1_1",
			"2_1",
			"0_6",
			"7_2",
			"7_4",
			"5_2",
			"0_8",
			"5_3",
			"6_3",
			"4_0",
			"5_4",
			"1_8",
			"3_6"
		],
		"grid": [
			"000000000000000000000000000000000000000000000000000100000000000000000000000000000000000000000000",
			"020202020202020202020202030004000000000000000005000106070707070707070707070707070707070707070800",
			"090909090909090909090909030000000000001000000000000100000000000000000000000000000000000000001100",
			"000000000000000000000000030000000000000000000000000100000000000000000000000000000000000005001100",
			"000000120000000000000000030000000000000000000000000100000000000000000000000000000000000000001100",
			"000000000000000013000000030000000004000000000000000100000000000000000000000000000000000000001100",
			"000000000000000000000000030000000000000000000000000100000000000000000000000000000000000000001100",
			"000000000000000000000000030000000000000000000000000100000000000000000000000000000000000000001100",
			"000000000000000000000000030000141515160000000000000100000000000000000000000000000000000000001100",
			"000000000000000012000000030000030000010005000000000100000000000000000000000000000000000000001100",
			"000000001415151515151515151515001700010000000000000100000000000000000000000000000000000000001100",
			"181819000300000000000000001000000000010000000000000100000000000000000000000000000000000000001100",
			"002000000300000000000004000000000001210001020202022100000000000000000000000000000000000000001100",
			"001100000305000000000000000000120001220001090909092200000000000000000004000000000000000000001100",
			"001100002302020202020202020202020221000001000000000000000000000000000400000000000000000005002400",
			"001100002526262626262626090909090922000001000000000000000000000000000000000000000000000005002700",
			"001100002526262626262626030000000000001701000000000000000000000000000000000000000000000000002700",
			"001112002809090909090909030000000000000001000000000000000000000000000000000000000000000000002700",
			"001100000000000000000000030000000000000001000000000000000000000000000000000000000000000000000000",
			"001100001000000000000000030010000000000001000000000000000000000000000000000000000000000000000000",
			"001100000000000000000000030000000000000001000000000000000000000000000000000000000000000000000000",
			"001100000000000012000000230202020202020221000000000000000000000000000000000000000000000000000000",
			"001100000000000000000000280909090909090922000000000000000000000000000000000000000000000000000000",
			"001100000000000000000000000000000000000000000000000000000000000000000000000000000000000000000000",
			"001100001700000000000000000000000000000000000000000000000000000000000000000000000000000000000000",
			"001100000000000000000000000000000000000000000000000000000000000000000000000000000000000000000000",
			"001100000000000000000000000000000000000000000000000000000000000000000000000000000000000000000000",
			"001100000000000000000000000000000000000000000000000000000000000000000000000000000000000000000000",
			"001100000000000000000000000000000000000000000000000000000000000000000000000000000000000000000000",
			"001100000000000017000000000000000017000000000000000000000000000000000000000000000000000000000000",
			"001100000000000000000000000000000000000000000000000000040000000000000000000000000000000000000000",
			"001100000000000000000000000000000400000000000000000000000000000000000000000000000000000000000000",
			"001100000000000000000000000000000000000000050000000400000000000000000000000000000000000000000000",
			"001100000000000000000000000000000000000000000000000000000000000000000000000000000000000000000000",
			"001100000000000000000000000000000000000000000000000000000000000000000000000000000000000000000000",
			"001100000017000000000000000000000000000000000000000000000000000000000000000000000000000000000000",
			"001100000000000000000000000000000000000000000000000000000000000000000000000000000000000000000000",
			"001100000000001700000000000004000000000000000000000000000000000000000000000000000000000000000000",
			"001100000000000000000000000000000000000000000000000000000000000000000000000000000000000000000000",
			"001100000000000000000000000000000000000000000000000000000000000000000000000000000000000000000000",
			"001100000000000000000000000000000000000000000000000000000000000000000000000000000000000000000000",
			"001100000000000000000000000000000000000017000000000000000000000000000000000000000000000000000000",
			"001100000400000000000000000000000000000000000000000000000000000000000000000000000000000000000000",
			"001100000000000000000000000000000000000000000000000000000000000000000000000000000000000000000000",
			"001100000000000000000000000000000000000000000000000000000000000000000000000000000000000000000000",
			"001100000000000000000000000000000000000000000000000000000000000000000000000000000000000000000000",
			"002907070707070707073027270607070707070707073000000000000000000000000000000000000000000000000000",
			"000000000000000000000000000000000000000000000000000000000000000000000000000000000000000000000000"
		]
	}
}