{
	"width": 48,
	"height": 48,
	"ambient": null,
	"baseLayer": {
		"ids": [
			"GROUND_0_0",
			"GROUND_2_1",
			"WATER",
			"GROUND_1_0",
			"GROUND_3_0",
			"GROUND_0_2"
		],
		"grid": [
			"111111111111111111111223333333333333333333333333",
			"111111111111111111111223333333333333333333333333",
			"111111111111111111111223333333333333333333333333",
			"111111111144441111111222333333333333333333333333",
			"111155551144441155551122333333333333333333333333",
			"111155551144441155551122233333333333333333333333",
			"111155551144441155551112223333333333333333333333",
			"111115111144441111511111222233333333333333333333",
			"111111111144441111111111122222233333333333333333",
			"111144444444444444441111112222222222222222222222",
			"111144444444444444441111111112222222222222222222",
			"111144444444444444441111111111122222222222222222",
			"111111111144441111111111111111111111111111111111",
			"111111111144441111111111111111111111111111111111",
			"111111111144441155511111111111111111111111111111",
			"111111111144441155511111111111111111111111111111",
			"111111111144441115111111111114444111111111111111",
			"111111111144441155555551111114444115555511111111",
			"111111111144441155555551111114444115555511111111",
			"111111111144441155555551111114444115555511111111",
			"111111111144441115111111111114444111515111111111",
			"111111111144441111111111111114444111111111111111",
			"111444444444444444444444444444444444444441111111",
			"111444444444444444444444444444444444444441111111",
			"111444444444444444444444444444444444444441111111",
			"111111111111111111111111111114444111111111111111",
			"111111111111111111111111111114444111111111111111",
			"111111111111111111111111111114444111111111111111",
			"111111111111111111111555555114444111111111111111",
			"111111111111111111111555555114444111111111111111",
			"111111111111111111111555555114444111111111111111",
			"111111111111111111111151111114444111111111111111",
			"111166111111111111111111111114444111111111111111",
			"111661111111111111111444444444444444444444444111",
			"111111111111111111111444444444444444444444444111",
			"111111114444111111111444444444444444444444444111",
			"111111444444441111661111111111111111111111111111",
			"111114444444444111166611111111111111111111111111",
			"111114446664444111166111111111111111111111111111",
			"111114446666444441111111111111111111111111111111",
			"111114444666444441111111111111111111111111111111",
			"111111444444444441111111111111111111111111111111",
			"111111114444411111111111111111111111111111111111",
			"111111111111111111111111111111111111111111111111",
			"111111111111111666611111111111111111111111111111",
			"111111111111111166111111111111111111111111111111",
			"111111111111111111111111111111111111111111111111",
			"111111111111111111111111111111111111111111111111"
		]
	},
	"overLayer": {
		"ids": [
			"0_0_0_1",
			"2_1_0_1",
			"2_1_0_2",
			"2_1_4_0",
			"0_0_0_0",
			"0_0_1_0",
			"0_0_2_0",
			"0_0_0_2",
			"0_0_4_0",
			"0_0_2_1",
			"2_1_1_2",
			"0_0_1_5",
			"0_0_4_1",
			"0_0_3_1",
			"0_0_1_2",
			"0_0_3_0",
			"0_0_2_2",
			"0_2_3_3",
			"0_2_1_5",
			"0_2_4_3",
			"0_2_2_5",
			"0_2_0_5",
			"0_2_2_4",
			"0_2_0_3",
			"0_2_1_3",
			"0_2_4_4",
			"0_2_3_4",
			"0_2_2_3",
			"1_0_3_3",
			"1_0_1_5",
			"1_0_4_3",
			"1_0_2_5",
			"1_0_0_5",
			"1_0_2_4",
			"1_0_0_4",
			"0_2_0_4",
			"1_0_3_4",
			"1_0_2_3",
			"1_0_1_3",
			"1_0_0_3",
			"1_0_4_4"
		],
		"grid": [
			"000000000000000000000000000000000000000000010002000000000000000000000000000000000000000000000000",
			"000000000000000000000000000000000000000000010002000000000000000000000000000000000000000000000000",
			"000000000000000000000000000000000000000000010003040000000000000000000000000000000000000000000000",
			"000000000000000000000506060700000000000000080900020000000000000000000000000000000000000000000000",
			"000000000000000000000100001000000000000000000100030400000000000000000000000000000000000000000000",
			"000000000000000000000100001000000000000000000809000304000000000000000000000000000000000000000000",
			"000000000000000000000100001000000000000000000008090003110400000000000000000000000000000000000000",
			"000000000012000000000100001000000000120000000000080900000311110400000000000000000000000000000000",
			"000000000000000000000100001000000000000000000000000809000000000311111111111111111111111111111111",
			"000000000506060606061300001406060606060700000000000008151509000000000000000000000000000000000000",
			"000000000100000000000000000000000000001000000000000000000008150900000000000000000000000000000000",
			"000000000815151515150900001615151515151700000000000000000000000815151515151515151515151515151515",
			"000000000000000000000100001000000000000000000000000000000000000000000000000000000000000000000000",
			"000000000000000000000100001000000000000000000000000000000000000000000000000000000000000000000000",
			"000000000000000000000100001000000000000000000000000000000000000000000000000000000000000000000000",
			"000000000000000000000100001000000000000000000000000000000000000000000000000000000000000000000000",
			"000000000000000000000100001000000000000000000000000000000005060607000000000000000000000000000000",
			"000000000000000000000100001000000000000000000000000000000001000010000000000000000000000000000000",
			"000000000000000000000100001000000000000000000000000000000001000010000000000000000000000000000000",
			"000000000000000000000100001000000000000000000000000000000001000010000000000000000000000000000000",
			"000000000000000000000100001000000012000000000000000000000001000010000000120012000000000000000000",
			"000000000000000000000100001000000000000000000000000000000001000010000000000000000000000000000000",
			"000000050606060606061300001406060606060606060606060606060613000014060606060606060700000000000000",
			"000000010000000000000000000000000000000000000000000000000000000000000000000000001000000000000000",
			"000000081515151515151515151515151515151515151515151515151509000016151515151515151700000000000000",
			"000000000000000000000000000000000000000000000000000000000001000010000000000000000000000000000000",
			"000000000000000000000000000000000000000000000000000000000001000010000000000000000000000000000000",
			"000000000000000000000000000000000000000000000000000000000001000010000000000000000000000000000000",
			"000000000000000000000000000000000000000000000000000000000001000010000000000000000000000000000000",
			"000000000000000000000000000000000000000000000000000000000001000010000000000000000000000000000000",
			"000000000000000000000000000000000000000000000000000000000001000010000000000000000000000000000000",
			"000000181919200000000000000000000000000000001200000000000001000010000000000000000000000000000000",
			"000018210000222000000000000000000000000000000000000000000001000010000000000000000000000000000000",
			"000023000024252600000000000000000000000000050606060606060613000014060606060606060606060607000000",
			"000027282426002930303030310000000000000000010000000000000000000000000000000000000000000010000000",
			"000000272629303200000000333031001819191920081515151515151515151515151515151515151515151517000000",
			"000000002932000000000000000033312728000022192000000000000000000000000000000000000000000000000000",
			"000000003400001819191920000000350027280000003600000000000000000000000000000000000000000000000000",
			"000000003400002300000022200000333031230000242600000000000000000000000000000000000000000000000000",
			"000000003400002300000000360000000035272525260000000000000000000000000000000000000000000000000000",
			"000000003400002728000000222000000035000000000000000000000000000000000000000000000000000000000000",
			"000000003738000027252525252600000035000000000000000000000000000000000000000000000000000000000000",
			"000000000037393800000000004039393941182000000000000000000000000000000000000000000000000000000000",
			"000000000000003739393939394118191919213600000000000000000000000000000000000000000000000000000000",
			"000000000000000000000000001821000000003600000000000000000000000000000000000000000000000000000000",
			"000000000000000000000000002725280000242600000000000000000000000000000000000000000000000000000000",
			"000000000000000000000000000000272525260000000000000000000000000000000000000000000000000000000000",
			"000000000000000000000000000000000000000000000000000000000000000000000000000000000000000000000000"
		]
	},
	"wallLayer": {
		"ids": [
			"0_0"
		],
		"grid": [
			"000000000000000000000000000000000000000000000000",
			"000000000000000000000000000000000000000000000000",
			"000000000000000000000000000000000000000000000000",
			"000111111000000111111000000000000000000000000000",
			"000100001000000100001000000000000000000000000000",
			"000100001000000100001000000000000000000000000000",
			"000100001000000100001000000000000000000000000000",
			"000110111000000111011000000000000000000000000000",
			"000000000000000000000000000000000000000000000000",
			"000000000000000000000000000000000000000000000000",
			"000000000000000000000000000000000000000000000000",
			"000000000000000000000000000000000000000000000000",
			"000000000000000000000000000000000000000000000000",
			"000000000000000111110000000000000000000000000000",
			"000000000000000100010000000000000000000000000000",
			"000000000000000100010000000000000000000000000000",
			"000000000000000110111111000000000011111110000000",
			"000000000000000100000001000000000010000010000000",
			"000000000000000100000001000000000010000010000000",
			"000000000000000100000001000000000010000010000000",
			"000000000000000110111111000000000011010110000000",
			"000000000000000000000000000000000000000000000000",
			"000000000000000000000000000000000000000000000000",
			"000000000000000000000000000000000000000000000000",
			"000000000000000000000000000000000000000000000000",
			"000000000000000000000000000000000000000000000000",
			"000000000000000000000000000000000000000000000000",
			"000000000000000000001111111100000000000000000000",
			"000000000000000000001000000100000000000000000000",
			"000000000000000000001000000100000000000000000000",
			"000000000000000000001000000100000000000000000000",
			"000000000000000000001101111100000000000000000000",
			"000000000000000000000000000000000000000000000000",
			"000000000000000000000000000000000000000000000000",
			"000000000000000000000000000000000000000000000000",
			"000000000000000000000000000000000000000000000000",
			"000000000000000000000000000000000000000000000000",
			"000000000000000000000000000000000000000000000000",
			"000000000000000000000000000000000000000000000000",
			"000000000000000000000000000000000000000000000000",
			"000000000000000000000000000000000000000000000000",
			"000000000000000000000000000000000000000000000000",
			"000000000000000000000000000000000000000000000000",
			"000000000000000000000000000000000000000000000000",
			"000000000000000000000000000000000000000000000000",
			"000000000000000000000000000000000000000000000000",
			"000000000000000000000000000000000000000000000000",
			"000000000000000000000000000000000000000000000000"
		]
	},
	"attribLayer": {
		"ids": [
			"BLOCK",
			"WARP: newbie_north_route 11 45",
			"WARP: newbie_north_route 12 45",
			"OBJECT: rock_pointy",
			"OBJECT: fishing_spot",
			"OBJECT: range",
			"NPC: man_a",
			"NPC: woman_b",
			"OBJECT: door_closed",
			"NPC_AVOID",
			"OBJECT: torch_common",
			"OBJECT: bush_strawberry",
			"OBJECT: tree_common",
			"ITEM: coffee",
			"NPC: woman_c",
			"NPC: man_b",
			"NPC: man_c",
			"OBJECT: bush",
			"WARP: slime_grove 14 7",
			"OBJECT: crate_small",
			"NPC: t_t_c",
			"WARP: newbie_east_route 2 32",
			"NPC: mining_tutor",
			"WARP: newbie_east_route 2 33",
			"OBJECT: ore_copper"
		],
		"grid": [
			"000000000000000000000000000000000000000000000001000000000000000000000000000000000000000000000000",
			"000101010101010101010102030101010101010101010101010101000000000000000000000000000000000000000000",
			"000100000000000000000000000000000000000000000001000001000000000000000000000000000000000400000000",
			"000100010101010101000000000000010101010101000000050001000000000000000000000000000000000000000000",
			"000100010000000001000000000000010000060001000000010101000000000000000000000000000000000000040000",
			"000100010000070001000000000000010008000001000000000101000000000000000000000000000000000000000000",
			"000100010000000001000000000000010000000001000000000001010100000000000000000000000101010101010000",
			"000100010109010101000000000000010101090101000000000000000101010100000000000000000100000000010000",
			"000100000010000000110000000011001200100000000000000000000000000101010101010101010105000500010101",
			"000100000000000000000000000000000000000000000013000000000000000000000000000000000000000000000100",
			"000100000000000000000000000000000000000000000000000000000000000000000000000000000000000000000100",
			"000100000000000000000000000000000000000000000000000000000000000000000000000000000000000000000100",
			"000100000000000000110000000011000000000000000000000000000000000000000000000000000000000000000100",
			"000100000000000000000000000000010101010100000000000000000000000000001300000000000013000000000100",
			"000100000000000000000000000000011400000100130000000000000000000000000000000000000000000000000100",
			"000100001300000000000000000000010000000100000000000000000000000000000000000000000000000000000100",
			"000100000000000000000000000000010109010101010101000000000000000000000101010101010100000000000100",
			"000100000000000000000000000000010000000000000001000000000000000000000100000000000100000000000100",
			"000100000000000000000000000000010015000000160001000000000000000000000100170000000100000000000100",
			"000100001800000013000000000000010000000000000001000000000000000000000100000000000100000000000100",
			"000100000000000000000000000000010109010101010101000000130000000000000101090109010100000000000100",
			"000100000000000000110000000011000010120000000000000000001100000000110000100010000000000000000100",
			"000100000000000000000000000000000000000000000000000000000000000000000000000000000000000000000100",
			"001900000000000000000000000000000000000000000000000000000000000000000000000000000000000000000100",
			"001900000000000000000000000000000000000000000000000000000000000000000000000000000000130000000100",
			"000100000000000000000000000000000000000000000000000000001100000000110000000000000000000000000100",
			"000100000000000000000000000000000000000000000000000000000000000000000000130000000000000000000100",
			"000100000000000000130000000000000000000001010101010101010000000000000000000000000000000000000100",
			"000100000000000000000000000000000000000001202000000000010000000000000000000000000000000000000100",
			"000100000013000000000000000000000000000001000000002100010000000000000000000000000000000000000100",
			"000100000000000000000000000000001300000001000000000000010000000000000000000000000000130000000100",
			"000100010101010000000013000000000000000001010901010101010000000000000000130000000000000000000100",
			"000101010101010110101010101010000000000000001018001800001100000000110000000000000000000000000100",
			"000101010101010100000000000000180000000000000000000000000000000000000000000000000000000000000100",
			"000101010113000000000000000000001000000000000000000000000000000000000000000000000000000000002200",
			"000100010100002300000000001100000101010101000000000000000000000000000000000000000000000000002400",
			"000100000000000000002500000000000101010101010100000000000000000000000000000000000000000000000100",
			"000100000000250001010101000000000013010101010100000000000000000000000000000000000000000000000100",
			"000100000000000101010101250000000000010101010100000018000000000000000013000000000000000000000100",
			"000100000000000101010101010000000000010101010000000000000000000000000000000000000000000000000100",
			"000100000000000101010101012500000000001000000000000000000000000000000000000000000000130000000100",
			"000100000000000025000101010100000000001013000000000000000000000000000000000000000000000000000100",
			"000100000000000000000000000000000025000100000018000000000000001300000000000000130000000000000100",
			"000100000011000000000000000001010101010100000000000000000000000000000000000000000000000000000100",
			"000100000000000000000000000101010101010100000000000000000000000000000000000000000000000000000100",
			"000100000000000000000000000101010101010100000000000000000000000000000000000000000000000000000100",
			"000101010101010101010101010101010101010101010101010101010101010101010101010101010101010101010100",
			"000000000000000000000000000000000000000000000000000000000000000000000000000000000000000000000000"
		]
	},
	"decoLayer": {
		"ids": [
			"1_7",
			"2_6",
			"3_6",
			"4_0",
			"1_6",
			"0_7",
			"3_2",
			"0_0",
			"1_0",
			"0_6",
			"2_9",
			"3_9",
			"4_9",
			"2_0",
			"3_0",
			"0_8",
			"1_8",
			"2_8"
		],
		"grid": [
			"000000000000000000000000000000000000000000000000000000000000000000000000000000000000000000000000",
			"000102020202020202020304040502020202020202020300000000000000000000000000000000000000000000000000",
			"000600000000000000000007000000000000000000000000000000000000000000000000000000000000000000000000",
			"000600000000000000000000000000000000000000000000000000000000000000000000000000000000000000000000",
			"000600000000000000000000000000000000000000000000000000000000000000000000000000000000000000000000",
			"000600000000000000000000000000000000000000000000000000000000000000000000000000000000000000000000",
			"000600000000000000000000000000000000000000000000000000000000000000000000000000000000000000000000",
			"000600000000000000000000000000000000000000000000000000000000000000000000000000000000000000000000",
			"000600000000080800000000000000000000000909000000000000000000000000000000000000000000000000000000",
			"000600000000000000000000000000000000000000000000000000000000000000000000000000000000000000001000",
			"000600000000000000000000000000000000000000000000000700000000000000000000000000000000000000000600",
			"000600000000000000000000000000000000000000000000000000000000000000000000000000000000000000000600",
			"000611121212121213000000000000000000000000000000000000000000000000000000000000000000000000000600",
			"000600000000000000000000000000000000000000000000000000000000080000000000000000000000000000000600",
			"000600000000000000000000000000000000000000000000000000000000000000000000000009000000000000000600",
			"000600000000090000000000000000000000000000000000000900000000000000000000000000000000000000000600",
			"000600000000000000000000000000000000000000000000000000000000000000000000000000000000000000000600",
			"000600000000000000000000000000000000000000000000000000000000000000000000000000000000000000000600",
			"000600000000000700000000000000000000000000000000000000000000000000000000000000000000001400000600",
			"000600000000000000000000000000000000000000000000000000000000000000000000000000000000000000000600",
			"000600000000150000000000000000000000000000000000000000000000000000000000000000000000080000000600",
			"000600000000000000000000000000000000000000090909000000000000000000000000000000000000000000000600",
			"001600000000000000000000000000000000000000000000000000000000000000000000000000000000000000000600",
			"000400000000000000000000000000000000000000000000000000000000000000000000000000000000000000000600",
			"000400000000000000000000000000000000000000000000000000000000000000000000000000000000000000000600",
			"001000000000000000000000140000000000090000000000000000000000000000000000000000000000000000000600",
			"000600000009000000000000000000000000000000000000090000000000000000090000000000000000000009000600",
			"000600000000000000000000000008000000000000000000000000000000000000000000000000001500000000000600",
			"000600000000000000000000000000000000000000000000000000000000000000000000150000000000000000000600",
			"000600000000000000000000000000000000000000000000000000000000000000000000000000000000000000000600",
			"000600000000000015000000000000000000000000000000000000000000000000000000000000000000000000000600",
			"000600000000000000000000000000000000000000000000000000000000000000000000000000000000000000000600",
			"000600000000000000000000000000000000000000000000000000000000000000000000000000090000000000000600",
			"000600000000000000000000000000000000001500000000000000000000000000000000000000000000000000001600",
			"000600000000000000000000000000000000000000000000000000000000000000000000000000000000000000000400",
			"000600000000000000000000000000000000000000000000000000000000000000000000000000000000000700000400",
			"000600000000000000000000000000000000000000000000140000000000000000000000000000000000000000001000",
			"000600000000000000000000000000000000000000000000000000000000000008000000000000000000000000000600",
			"000600000000000000000000000000000000000000000000000000000000000000000000000000001500000000000600",
			"000600000000000000000000000000000000000000000000000000000000000000000000000000000000000000000600",
			"000600000000000000000000000000000000000000000000000000000014000000000000000900000000000000000600",
			"000600000000000000000000000000000000000000000000000000000000000000000000000000000000000000000600",
			"000600000000000000000000000000000000000000000000000000000000000000000000000000000000000000000600",
			"000600000900000000000000000000000000000000000000000000150000000000000000000000000000000000000600",
			"000600000000000000000000000000000000000000000000000000000000000000000000000000000000000000000600",
			"000600000000000000000000000000000000000000000000000000000000000000000000000000000000000000000600",
			"001702020202020202020202020202020202020202020202020202020202020202020202020202020202020202021800",
			"000000000000000000000000000000000000000000000000000000000000000000000000000000000000000000000000"
		]
	}
}