{
	"width": 48,
	"height": 48,
	"ambient": null,
	"baseLayer": {
		"ids": [
			"GROUND_0_0",
			"GROUND_1_0",
			"GROUND_2_0",
			"GROUND_2_1",
			"WATER"
		],
		"grid": [
			"111111111111111111111111111111111111111111111111",
			"111111111111111111111111111111111111111111111111",
			"111111111111111111111111111111111111111111111111",
			"111111111111111111111111112221111111111111111111",
			"111111333311111111111111112221113333333333331111",
			"111113333311111111111111112221113333333333331111",
			"111113333311111111111111112221113333333333331111",
			"111113333311111111111111112221133333333333331111",
			"111111333111111111111111112221133333333333331111",
			"111111111111111111111111112221113333333333331111",
			"111111111111111111111111112221113333333333331111",
			"111111111111111111111111112221113333333333331111",
			"111111111111111111111111112221111111133111111111",
			"111111111111111111111111112221111111111111111111",
			"111111111111111111111111112221111111111111111111",
			"111111111111111111111111112221111111111111111111",
			"111111111111111111111111112221111111111111111444",
			"111111111111111111111111111111111111111111444444",
			"111111111111111111111111111111111111111114444445",
			"111111111111111111111111111111111111111444445555",
			"111111111111111111111111111111111111111444555555",
			"111111111111111111111112221111111111111445555555",
			"111111111111111111111112221111111111111445555555",
			"111111111111111111111112221111111111111445555555",
			"111111111111111111111112221111111111111445555555",
			"111111111122222222222222221111111111111445555555",
			"111111111122222222222222221111111111111445555555",
			"111111111122222222222222221111111111144445555555",
			"111111111122211111111111111111111111444445555555",
			"111111111122211111111111111111111444444445555555",
			"111111111122211111111111111111144444444455555555",
			"111111111122211111111111111114444444444455555555",
			"111111111122211111111111111114444455555555555555",
			"111111111122211111111111111144455555555555555555",
			"111111111122211111111111111444555555555555555555",
			"111111111122211111111111111445555555555555555555",
			"111111111122211111111111114445555555555555555555",
			"111111111122211111111111114455555555555555555555",
			"111111111122211111111111144555555555555555555555",
			"111111111122211111111111444555555555555555555555",
			"111111111122211111111114445555555555555555555555",
			"111111111122211111111144455555555555555555555555",
			"111111111122211111111144555555555555555555555555",
			"111111111122211111111444555555555555555555555555",
			"111111111111111111111445555555555555555555555555",
			"111111111111111111111445555555555555555555555555",
			"111111111111111111111445555555555555555555555555",
			"111111111111111111111445555555555555555555555555"
		]
	},
	"overLayer": {
		"ids": [
			"0_0_0_0",
			"0_0_1_0",
			"0_0_2_0",
			"0_0_0_3",
			"0_0_1_3",
			"0_0_2_3",
			"0_0_0_1",
			"0_0_2_1",
			"0_0_4_4",
			"0_0_2_4",
			"0_0_0_4",
			"2_0_3_3",
			"2_0_2_5",
			"0_0_0_5",
			"0_0_4_3",
			"0_0_3_3",
			"0_0_2_5",
			"2_0_2_4",
			"0_0_1_5",
			"2_0_3_4",
			"2_0_2_3",
			"2_0_0_3",
			"2_0_1_3",
			"2_0_4_4",
			"0_0_0_2",
			"0_0_1_2",
			"0_0_2_2",
			"0_0_4_1",
			"2_1_0_0",
			"2_1_1_0",
			"2_1_4_1",
			"2_1_0_1",
			"0_0_3_0"
		],
		"grid": [
			"000000000000000000000000000000000000000000000000000000000000000000000000000000000000000000000000",
			"000000000000000000000000000000000000000000000000000000000000000000000000000000000000000000000000",
			"000000000000000000000000000000000000000000000000000000000000000000000000000000000000000000000000",
			"000000000000000000000000000000000000000000000000000001020300000000000000000000000000000000000000",
			"000000000000040505060000000000000000000000000000000007000800000000000000000000000000000000000000",
			"000000000004090000100000000000000000000000000000000007000800000000000000000000000000000000000000",
			"000000000011000000100000000000000000000000000000000007000800121300000000000000000000000000000000",
			"000000000014150016170000000000000000000000000000000007000800180000000000000000000000000000000000",
			"000000000000141917000000000000000000000000000000000007000800180000000000000000000000000000000000",
			"000000000000000000000000000000000000000000000000000007000800202100000000000000000000000000000000",
			"000000000000000000000000000000000000000000000000000007000800000000000000000000000000000000000000",
			"000000000000000000000000000000000000000000000000000007000800000000000000000000000000000000000000",
			"000000000000000000000000000000000000000000000000000007000800000000000000210000220000000000000000",
			"000000000000000000000000000000000000000000000000000007000800000000000000202323240000000000000000",
			"000000000000000000000000000000000000000000000000000007000800000000000000000000000000000000000000",
			"000000000000000000000000000000000000000000000000000007000800000000000000000000000000000000000000",
			"000000000000000000000000000000000000000000000000000025262700000000000000000000000000000000010202",
			"000000000000000000000000000000000000000000000000000000000000000000000000000000000000010202280000",
			"000000000000000000000000000000000000000000000000000000000000000000000000000000000001280000000029",
			"000000000000000000000000000000000000000000000000000000000000000000000000000000010228000029303031",
			"000000000000000000000000000000000000000000000000000000000000000000000000000000070000293031000000",
			"000000000000000000000000000000000000000000000001020300000000000000000000000000070029310000000000",
			"000000000000000000000000000000000000000000000007000800000000000000000000000000070032000000000000",
			"000000000000000000000000000000000000000000000007000800000000000000000000000000070032000000000000",
			"000000000000000000000000000000000000000000000007000800000000000000000000000000070032000000000000",
			"000000000000000000000102020202020202020202020228000800000000000000000000000000070032000000000000",
			"000000000000000000000700000000000000000000000000000800000000000000000000000000070032000000000000",
			"000000000000000000000700332626262626262626262626262700000000000000000000000102280032000000000000",
			"000000000000000000000700080000000000000000000000000000000000000000000000012800000032000000000000",
			"000000000000000000000700080000000000000000000000000000000000000000010202280000000032000000000000",
			"000000000000000000000700080000000000000000000000000000000000000102280000000000002931000000000000",
			"000000000000000000000700080000000000000000000000000000000001022800000000000000003200000000000000",
			"000000000000000000000700080000000000000000000000000000000007000000002930303030303100000000000000",
			"000000000000000000000700080000000000000000000000000000000128002930303100000000000000000000000000",
			"000000000000000000000700080000000000000000000000000000012800293100000000000000000000000000000000",
			"000000000000000000000700080000000000000000000000000000070029310000000000000000000000000000000000",
			"000000000000000000000700080000000000000000000000000001280032000000000000000000000000000000000000",
			"000000000000000000000700080000000000000000000000000007002931000000000000000000000000000000000000",
			"000000000000000000000700080000000000000000000000000128293100000000000000000000000000000000000000",
			"000000000000000000000700080000000000000000000000012800320000000000000000000000000000000000000000",
			"000000000000000000000700080000000000000000000001280029310000000000000000000000000000000000000000",
			"000000000000000000000700080000000000000000000128002931000000000000000000000000000000000000000000",
			"000000000000000000000700080000000000000000000700293100000000000000000000000000000000000000000000",
			"000000000000000000002526270000000000000000012800320000000000000000000000000000000000000000000000",
			"000000000000000000000000000000000000000000070029310000000000000000000000000000000000000000000000",
			"000000000000000000000000000000000000000000070032000000000000000000000000000000000000000000000000",
			"000000000000000000000000000000000000000000070032000000000000000000000000000000000000000000000000",
			"000000000000000000000000000000000000000000070032000000000000000000000000000000000000000000000000"
		]
	},
	"wallLayer": {
		"ids": [
			"1_0"
		],
		"grid": [
			"000000000000000000000000000000000000000000000000",
			"000000000000000000000000000000000000000000000000",
			"000000000000000000000000000000000000000000000000",
			"000000000000000000000000000000000000000000000000",
			"000000000000000000000000000000001111111111110000",
			"000000000000000000000000000000001000000000010000",
			"000000000000000000000000000000001000000000010000",
			"000000000000000000000000000000000000000000010000",
			"000000000000000000000000000000000000000000010000",
			"000000000000000000000000000000001000000000010000",
			"000000000000000000000000000000001000000000010000",
			"000000000000000000000000000000001111100111110000",
			"000000000000000000000000000000000000000000000000",
			"000000000000000000000000000000000000000000000000",
			"000000000000000000000000000000000000000000000000",
			"000000000000000000000000000000000000000000000000",
			"000000000000000000000000000000000000000000000000",
			"000000000000000000000000000000000000000000000000",
			"000000000000000000000000000000000000000000000000",
			"000000000000000000000000000000000000000000000000",
			"000000000000000000000000000000000000000000000000",
			"000000000000000000000000000000000000000000000000",
			"000000000000000000000000000000000000000000000000",
			"000000000000000000000000000000000000000000000000",
			"000000000000000000000000000000000000000000000000",
			"000000000000000000000000000000000000000000000000",
			"000000000000000000000000000000000000000000000000",
			"000000000000000000000000000000000000000000000000",
			"000000000000000000000000000000000000000000000000",
			"000000000000000000000000000000000000000000000000",
			"000000000000000000000000000000000000000000000000",
			"000000000000000000000000000000000000000000000000",
			"000000000000000000000000000000000000000000000000",
			"000000000000000000000000000000000000000000000000",
			"000000000000000000000000000000000000000000000000",
			"000000000000000000000000000000000000000000000000",
			"000000000000000000000000000000000000000000000000",
			"000000000000000000000000000000000000000000000000",
			"000000000000000000000000000000000000000000000000",
			"000000000000000000000000000000000000000000000000",
			"000000000000000000000000000000000000000000000000",
			"000000000000000000000000000000000000000000000000",
			"000000000000000000000000000000000000000000000000",
			"000000000000000000000000000000000000000000000000",
			"000000000000000000000000000000000000000000000000",
			"000000000000000000000000000000000000000000000000",
			"000000000000000000000000000000000000000000000000",
			"000000000000000000000000000000000000000000000000"
		]
	},
	"attribLayer": {
		"ids": [
			"BLOCK",
			"OBJECT: tree_common",
			"OBJECT: stump_common",
			"NPC: slime_weak",
			"WARP: newbie_cave_entrance 18 20",
			"OBJECT: tree_birch",
			"OBJECT: anvil",
			"OBJECT: furnace",
			"NPC_AVOID",
			"OBJECT: crate_small",
			"ISLAND",
			"NPC: red_slime",
			"WARP: newbie_capital 2 15",
			"WARP: newbie_capital 2 16",
			"OBJECT: bush",
			"WARP: newbie_capital 2 17",
			"OBJECT: tree_palm",
			"OBJECT: tree_apple",
			"OBJECT: bush_strawberry",
			"OBJECT: fishing_spot_down",
			"OBJECT: rock_pointy",
			"WARP: newbie_village 11 2",
			"WARP: newbie_village 12 2"
		],
		"grid": [
			"000000000000000000000000000000000000000000000000000100000000000000000000000000000000000000000000",
			"010101010101010101010101010000000000000000000000000102030203020302030203020302030203020302030200",
			"010101010101010101010101010000000200000000000000000100000000000000000000000000000000000000000300",
			"000000000000000000000000010000000000000000000000000100000000000000000000000000000000000000000300",
			"000200000400000000000200010000000000000000000000000100000000000001010101010101010101010100000200",
			"000000000000000005000000010002000000000600000000000100000000000001000000000000000000000100000300",
			"000400000000000000000000010000000000000000000000000100000000000001000700070000000800000100000300",
			"000000020000000000000000010000000000000000000600000100000000000009000000000000000000000100000200",
			"000000000000000000000000010000010101010000000000000100000000000009000000000000000000000100000300",
			"000200000002000000000200010000010002010000000000000100000000000001000000000000100000000100000300",
			"000000000101010101010101010101010000010000000000000100000000000001000000000000000000000100000200",
			"010101090100000000000000000000000000010000000000110100000000000001010101010909010101010100000300",
			"000000000100060000060000000002000000010001010101010100000000000000000000000000000000000000000300",
			"000200000100000000000000000000001101010001010101010100000000000000000000000000000000000000000200",
			"000300000101010101010101010101010101000001000000000000000000000000000000000012000000000000000300",
			"000300000101010101010101010101010101000001000000000000000000000200000000120000000000000000001300",
			"000200000101010101010101010000000000000001000200000000000000000000000000000000000200000000001400",
			"000300000101010101010101010015000000000001000000000000000000000000000000000000000000000000001600",
			"000300000000000000000000010000000000000001000000001200000000000000001500000000000000000000001701",
			"000200000000000000020000010000000015000001000000000000000000000000000000000000000000000001010101",
			"000300000000000000000000010000000000000001000000000000001200180000000000000000000000010101000000",
			"000300000000020000000000010101010101010101000000000000000000000000000000000000000001010000000000",
			"000200000000000000000000010101010101010101000000000000000000000000001800000000000001000000000000",
			"000300000000000000000000190019000019001900000000000000000000000000000000000000000001000000000000",
			"000300000000000000000000000000000000000000000000000000000000000000000000000000000001000000000000",
			"000200000000000002000000000000000000000000000000000000020000001800000000000000000001000000000000",
			"000300000000000000000000000000000000000000000000000000000000000000000000000000000001000000000000",
			"000300000000000000000000000000000000000000000000000000000000000000000000000000000001000000000000",
			"000200000000000000000000000000000000000200000000000000000015000000000000000000000001000000000000",
			"000300000000000000000000000000000000000000000000000000000000000000000000000000000001000000000000",
			"000300000200000000000000000002000000000400000000020000000000000000000000000000000101000000000000",
			"000200000000000000000000000000000000000000000000000000000000000000000000000000000100000000000000",
			"000300000000000000000000000000000000000000000000000000000000000000000101202020010100000000000000",
			"000300000000000000000000000000000015000000000000000000000000000101010100010101000000000000000000",
			"000200000000000200000000000000000000000000000000040000000000010100000000000000000000000000000000",
			"000300000000000000000000000000000000000000000000000000000001010000000000000000000000000000000000",
			"000300000000000000000000000000000000000000000400000000000001000000000000000000000000000000000000",
			"000200000000000000000000000000000000020000000000000000000101000000000000000000000000000000000000",
			"000300000000000000000000000000000000000000000000000000010100000000000000000000000000000000000000",
			"000300000200000000000000000000000000000000000000000000010000000000001100000000000000000000000000",
			"000200000000000000000000000000000000000000000000000001010000000000000000000000000000000000000000",
			"000300000000000000000000000000020000000000000000000101000000000000000000000000000000000000000000",
			"000300000000000200000000000000000000000000000000010100000000000000000000000000000000000000000000",
			"000200000000000000000000000000000000000000000000010000000000000000000000000000000000000000000000",
			"000300000000000000000000000000000000000000000001010000000000000000000000000000000000000000000000",
			"000300000000000000000000000000000000000000002101000000000000000000000000000000000000000000000000",
			"000203020302030203020322230203020302030203210001000000000000000000000000000000000000000000000000",
			"000000000000000000000000000000000000000000000001000000000000000000000000000000000000000000000000"
		]
	},
	"decoLayer": {
		"ids": [
			"7_1",
			"6_2",
			"5_1",
			"1_0",
			"2_0",
			"6_4",
			"3_2",
			"3_0",
			"0_2",
			"5_0",
			"6_0",
			"7_0",
			"0_0",
			"1_1",
			"2_1",
			"7_2",
			"7_4",
			"5_2",
			"5_3",
			"6_3",
			"4_0",
			"5_4"
		],
		"grid": [
			"000000000000000000000000000000000000000000000000000100000000000000000000000000000000000000000000",
			"020202020202020202020202030004000000000000000005000100000000000000000000000000000000000000000000",
			"060606060606060606060606030000000000000700000000000100000000000000000000000000000000000000000000",
			"000000000000000000000000030000000000000000000000000100000000000000000000000000000000000005000000",
			"000000080000000000000000030000000000000000000000000100000000000000000000000000000000000000000000",
			"000000000000000009000000030000000004000000000000000100000000000000000000000000000000000000000000",
			"000000000000000000000000030000000000000000000000000100000000000000000000000000000000000000000000",
			"000000000000000000000000030000000000000000000000000100000000000000000000000000000000000000000000",
			"000000000000000000000000030000101111120000000000000100000000000000000000000000000000000000000000",
			"000000000000000008000000030000030000010005000000000100000000000000000000000000000000000000000000",
			"000000001011111111111111111111001300010000000000000100000000000000000000000000000000000000000000",
			"141415000300000000000000000700000000010000000000000100000000000000000000000000000000000000000000",
			"000000000300000000000004000000000001160001020202021600000000000000000000000000000000000000000000",
			"000000000305000000000000000000080001170001060606061700000000000000000004000000000000000000000000",
			"000000001802020202020202020202020216000001000000000000000000000000000400000000000000000005000000",
			"000000001920202020202020060606060617000001000000000000000000000000000000000000000000000005002100",
			"000000001920202020202020030000000000001301000000000000000000000000000000000000000000000000002100",
			"000008002206060606060606030000000000000001000000000000000000000000000000000000000000000000002100",
			"000000000000000000000000030000000000000001000000000000000000000000000000000000000000000000000000",
			"000000000700000000000000030007000000000001000000000000000000000000000000000000000000000000000000",
			"000000000000000000000000030000000000000001000000000000000000000000000000000000000000000000000000",
			"000000000000000008000000180202020202020216000000000000000000000000000000000000000000000000000000",
			"000000000000000000000000220606060606060617000000000000000000000000000000000000000000000000000000",
			"000000000000000000000000000000000000000000000000000000000000000000000000000000000000000000000000",
			"000000001300000000000000000000000000000000000000000000000000000000000000000000000000000000000000",
			"000000000000000000000000000000000000000000000000000000000000000000000000000000000000000000000000",
			"000000000000000000000000000000000000000000000000000000000000000000000000000000000000000000000000",
			"000000000000000000000000000000000000000000000000000000000000000000000000000000000000000000000000",
			"000000000000000000000000000000000000000000000000000000000000000000000000000000000000000000000000",
			"000000000000000013000000000000000013000000000000000000000000000000000000000000000000000000000000",
			"000000000000000000000000000000000000000000000000000000040000000000000000000000000000000000000000",
			"000000000000000000000000000000000400000000000000000000000000000000000000000000000000000000000000",
			"000000000000000000000000000000000000000000050000000400000000000000000000000000000000000000000000",
			"000000000000000000000000000000000000000000000000000000000000000000000000000000000000000000000000",
			"000000000000000000000000000000000000000000000000000000000000000000000000000000000000000000000000",
			"000000000013000000000000000000000000000000000000000000000000000000000000000000000000000000000000",
			"000000000000000000000000000000000000000000000000000000000000000000000000000000000000000000000000",
			"000000000000001300000000000004000000000000000000000000000000000000000000000000000000000000000000",
			"000000000000000000000000000000000000000000000000000000000000000000000000000000000000000000000000",
			"000000000000000000000000000000000000000000000000000000000000000000000000000000000000000000000000",
			"000000000000000000000000000000000000000000000000000000000000000000000000000000000000000000000000",
			"000000000000000000000000000000000000000013000000000000000000000000000000000000000000000000000000",
			"000000000400000000000000000000000000000000000000000000000000000000000000000000000000000000000000",
			"000000000000000000000000000000000000000000000000000000000000000000000000000000000000000000000000",
			"000000000000000000000000000000000000000000000000000000000000000000000000000000000000000000000000",
			"000000000000000000000000000000000000000000000000000000000000000000000000000000000000000000000000",
			"000000000000000000000021210000000000000000000000000000000000000000000000000000000000000000000000",
			"000000000000000000000000000000000000000000000000000000000000000000000000000000000000000000000000"
		]
	}
}