{
	"width": 16,
	"height": 16,
	"ambient": null,
	"baseLayer": {
		"ids": [
			"GROUND_0_0"
		],
		"grid": [
			"1111111111111111",
			"1111111111111111",
			"1111111111111111",
			"1111111111111111",
			"1111111111111111",
			"1111111111111111",
			"1111111111111111",
			"1111111111111111",
			"1111111111111111",
			"1111111111111111",
			"1111111111111111",
			"1111111111111111",
			"1111111111111111",
			"1111111111111111",
			"1111111111111111",
			"1111111111111111"
		]
	},
	"attribLayer": {
		"ids": [
			"NPC_AVOID",
			"OBJECT: tree_common",
			"OBJECT: crate_small",
			"NPC: goblin_weak",
			"NPC: range_test",
			"ITEM: bow_sword"
		],
		"grid": [
			"0000000000000000",
			"0111102000002030",
			"0140100000000000",
			"0100100000000000",
			"0111100002005000",
			"0000000000000000",
			"0000000000000000",
			"0000002005002000",
			"0000000000000000",
			"0000000000000000",
			"0000000000000000",
			"0000000000000000",
			"0000000000000000",
			"0000000000000000",
			"0600000000000050",
			"0000000000000000"
		]
	},
	"decoLayer": {
		"ids": [
			"2_3",
			"3_3",
			"4_3",
			"2_4",
			"4_4",
			"2_5",
			"3_5",
			"4_5"
		],
		"grid": [
			"0000000000000000",
			"0122300000000000",
			"0400500000000000",
			"0400500000000000",
			"0677800000000000",
			"0000000000000000",
			"0000000000000000",
			"0000000000000000",
			"0000000000000000",
			"0000000000000000",
			"0000000000000000",
			"0000000000000000",
			"0000000000000000",
			"0000000000000000",
			"0000000000000000",
			"0000000000000000"
		]
	}
}