{
	"width": 20,
	"height": 20,
	"ambient": [
		0.24,
		0.24,
		0.14
	],
	"baseLayer": {
		"ids": [
			"GROUND_2_1"
		],
		"grid": [
			"11111111111111111111",
			"11111111111111111111",
			"11111111111111111111",
			"11111111111111111111",
			"11111111111111111111",
			"11111111111111111111",
			"11111111111111111111",
			"11111111111111111111",
			"11111111111111111111",
			"11111111111111111111",
			"11111111111111111111",
			"11111111111111111111",
			"11111111111111111111",
			"11111111111111111111",
			"11111111111111111111",
			"11111111111111111111",
			"11111111111111111111",
			"11111111111111111111",
			"11111111111111111111",
			"11111111111111111111"
		]
	},
	"wallLayer": {
		"ids": [
			"4_0",
			"1_0"
		],
		"grid": [
			"11111111111111111111",
			"10000000000000000001",
			"10000000000000000001",
			"10000000000000000001",
			"10000000000211110001",
			"10000000002112120001",
			"10000000022111110001",
			"10000000022111200001",
			"10000000022112000001",
			"10000000022112000000",
			"10000000002212000000",
			"10000000000010000001",
			"10000110000010000001",
			"10001001000010000001",
			"10000100100010000001",
			"10000011111100000001",
			"10000000000000000001",
			"10000000000000000001",
			"10000000000000000001",
			"11111111111111111111"
		]
	},
	"attribLayer": {
		"ids": [
			"BLOCK",
			"NPC: snake_weak",
			"OBJECT: ore_iron",
			"ISLAND",
			"TRIGGER: exit_snake_pit",
			"OBJECT: ore_copper"
		],
		"grid": [
			"11111111111111111111",
			"10000000000000000001",
			"10203000200020000201",
			"10000000000000000001",
			"10300200000111110001",
			"10000000001000010001",
			"10000000010020010001",
			"10200000010200100001",
			"10000000010001000001",
			"10000200014001000005",
			"10000000001101000005",
			"10000000000010002001",
			"10200110000010000001",
			"10001421000010000001",
			"10000100100010000001",
			"10000011111100600201",
			"10200000000002000001",
			"10000200000000006001",
			"10000000000000000001",
			"11111111111111111111"
		]
	},
	"decoLayer": {
		"ids": [
			"4_0"
		],
		"grid": [
			"00000000000000000000",
			"00000000000000000000",
			"00000000000000000000",
			"00000000000000000000",
			"00000000000000000000",
			"00000000000000000000",
			"00000000000000000000",
			"00000000000000000000",
			"00000000000000000000",
			"00000000000000000001",
			"00000000000000000001",
			"00000000000000000000",
			"00000000000000000000",
			"00000000000000000000",
			"00000000000000000000",
			"00000000000000000000",
			"00000000000000000000",
			"00000000000000000000",
			"00000000000000000000",
			"00000000000000000000"
		]
	}
}